"a" = (/obj/item/hilbertshotel/ghostdojo,/turf/template_noop,/area/template_noop)

(1,1,1) = {"
a
"}
