//MAP CONVERTED BY dmm2tgm.py THIS HEADER COMMENT PREVENTS RECONVERSION, DO NOT REMOVE
"a" = (
/obj/effect/mob_spawn/ghost_role/human/ash_walkers_slave{
	dir = 4
	},
/turf/template_noop,
/area/template_noop)
"t" = (
/turf/template_noop,
/area/template_noop)

(1,1,1) = {"
a
t
t
t
t
a
"}
(2,1,1) = {"
t
t
t
t
t
t
"}
(3,1,1) = {"
t
t
t
t
t
t
"}
(4,1,1) = {"
t
t
t
t
t
t
"}
(5,1,1) = {"
t
t
t
t
t
t
"}
(6,1,1) = {"
t
t
t
t
t
t
"}
(7,1,1) = {"
a
t
t
t
t
a
"}
