"a" = (/obj/structure/cable,/obj/machinery/atmospherics/pipe/smart/manifold4w/supply/hidden/layer4,/obj/machinery/atmospherics/pipe/smart/manifold4w/scrubbers/hidden/layer2,/obj/machinery/holopad,/obj/effect/turf_decal/tile/purple/opposingcorners,/obj/effect/landmark/event_spawn,/turf/open/floor/iron,/area/station/science/research)
"f" = (/obj/item/kirbyplants/random,/obj/effect/turf_decal/tile/purple/opposingcorners,/obj/structure/window/reinforced/spawner/directional/north,/turf/open/floor/iron,/area/station/science/research)
"i" = (/obj/structure/chair/comfy{dir = 8},/obj/machinery/airalarm/directional/south,/obj/machinery/atmospherics/components/unary/vent_scrubber/on/layer2{dir = 1},/obj/effect/landmark/start/scientist,/obj/effect/turf_decal/tile/purple/opposingcorners,/obj/structure/disposalpipe/segment{dir = 4},/turf/open/floor/iron,/area/station/science/research)
"k" = (/obj/structure/cable,/obj/machinery/atmospherics/pipe/smart/manifold4w/supply/hidden/layer4,/obj/effect/turf_decal/tile/purple/opposingcorners,/obj/structure/disposalpipe/segment{dir = 5},/turf/open/floor/iron,/area/station/science/research)
"l" = (/obj/structure/cable,/obj/effect/turf_decal/tile/purple/opposingcorners,/obj/structure/disposalpipe/segment{dir = 6},/turf/open/floor/iron,/area/station/science/research)
"m" = (/obj/machinery/door/window/right/directional/north{name = "Petting Zoo"},/obj/effect/turf_decal/tile/purple/opposingcorners,/obj/structure/disposalpipe/segment{dir = 10},/turf/open/floor/iron,/area/station/science/research)
"s" = (/obj/machinery/door/window/left/directional/north{name = "Petting Zoo"},/obj/effect/turf_decal/tile/purple/opposingcorners,/obj/structure/disposalpipe/segment{dir = 4},/turf/open/floor/iron,/area/station/science/research)
"u" = (/obj/effect/turf_decal/tile/purple/opposingcorners,/obj/structure/window/reinforced/spawner/directional/north,/obj/structure/disposalpipe/segment{dir = 6},/turf/open/floor/iron,/area/station/science/research)
"v" = (/obj/structure/table,/obj/structure/extinguisher_cabinet/directional/south,/obj/item/reagent_containers/cup/glass/mug/britcup{pixel_y = 2},/obj/effect/turf_decal/tile/purple/opposingcorners,/obj/machinery/light/small/directional/south,/obj/structure/disposalpipe/segment{dir = 5},/turf/open/floor/iron,/area/station/science/research)
"w" = (/obj/machinery/disposal/bin,/obj/structure/disposalpipe/trunk,/obj/effect/turf_decal/tile/purple/opposingcorners,/obj/structure/window/reinforced/spawner/directional/north,/turf/open/floor/iron,/area/station/science/research)
"x" = (/obj/structure/table,/obj/machinery/microwave,/obj/effect/turf_decal/tile/purple/opposingcorners,/obj/machinery/firealarm/directional/south,/obj/structure/disposalpipe/segment{dir = 9},/turf/open/floor/iron,/area/station/science/research)
"y" = (/obj/structure/table,/obj/effect/spawner/random/food_or_drink/donkpockets,/obj/effect/turf_decal/tile/purple/opposingcorners,/obj/machinery/light/small/directional/south,/obj/structure/disposalpipe/segment{dir = 4},/turf/open/floor/iron,/area/station/science/research)
"H" = (/obj/structure/cable,/obj/machinery/atmospherics/components/unary/vent_pump/on/layer4{dir = 8},/obj/effect/turf_decal/tile/purple/opposingcorners,/obj/structure/disposalpipe/segment{dir = 9},/turf/open/floor/iron,/area/station/science/research)
"K" = (/obj/structure/chair/comfy{dir = 4},/obj/item/radio/intercom/directional/south,/obj/effect/turf_decal/tile/purple/opposingcorners,/obj/structure/disposalpipe/segment{dir = 4},/turf/open/floor/iron,/area/station/science/research)
"T" = (/obj/structure/cable,/obj/machinery/atmospherics/pipe/smart/manifold4w/supply/hidden/layer4,/obj/machinery/atmospherics/pipe/smart/manifold4w/scrubbers/hidden/layer2,/obj/effect/turf_decal/tile/purple/opposingcorners,/obj/structure/disposalpipe/rotator,/turf/open/floor/iron,/area/station/science/research)

(1,1,1) = {"
usmwf
TakHl
viKyx
"}
