//MAP CONVERTED BY dmm2tgm.py THIS HEADER COMMENT PREVENTS RECONVERSION, DO NOT REMOVE
"a" = (
/obj/structure/table,
/obj/structure/extinguisher_cabinet/directional/south,
/obj/item/reagent_containers/cup/glass/mug/britcup{
	pixel_y = 2
	},
/obj/effect/turf_decal/tile/purple/opposingcorners,
/obj/machinery/light/small/directional/south,
/obj/structure/disposalpipe/segment{
	dir = 5
	},
/turf/open/floor/iron,
/area/station/science/research)
"e" = (
/obj/structure/table,
/obj/machinery/microwave,
/obj/effect/turf_decal/tile/purple/opposingcorners,
/obj/machinery/firealarm/directional/south,
/obj/structure/disposalpipe/segment{
	dir = 9
	},
/turf/open/floor/iron,
/area/station/science/research)
"g" = (
/obj/machinery/door/window/left/directional/north{
	name = "Petting Zoo"
	},
/obj/effect/turf_decal/tile/purple/opposingcorners,
/obj/structure/disposalpipe/segment{
	dir = 4
	},
/turf/open/floor/iron,
/area/station/science/research)
"i" = (
/obj/structure/cable,
/obj/machinery/atmospherics/pipe/smart/manifold4w/supply/hidden/layer4,
/obj/effect/turf_decal/tile/purple/opposingcorners,
/obj/structure/disposalpipe/segment{
	dir = 5
	},
/turf/open/floor/iron,
/area/station/science/research)
"s" = (
/obj/structure/chair/comfy{
	dir = 8
	},
/obj/machinery/airalarm/directional/south,
/obj/machinery/atmospherics/components/unary/vent_scrubber/on/layer2{
	dir = 1
	},
/obj/effect/landmark/start/scientist,
/obj/effect/turf_decal/tile/purple/opposingcorners,
/obj/structure/disposalpipe/segment{
	dir = 4
	},
/turf/open/floor/iron,
/area/station/science/research)
"t" = (
/obj/machinery/door/window/right/directional/north{
	name = "Petting Zoo"
	},
/obj/effect/turf_decal/tile/purple/opposingcorners,
/obj/structure/disposalpipe/segment{
	dir = 10
	},
/turf/open/floor/iron,
/area/station/science/research)
"u" = (
/obj/structure/cable,
/obj/machinery/atmospherics/pipe/smart/manifold4w/supply/hidden/layer4,
/obj/machinery/atmospherics/pipe/smart/manifold4w/scrubbers/hidden/layer2,
/obj/effect/turf_decal/tile/purple/opposingcorners,
/obj/structure/disposalpipe/rotator,
/turf/open/floor/iron,
/area/station/science/research)
"v" = (
/obj/structure/chair/comfy{
	dir = 4
	},
/obj/item/radio/intercom/directional/south,
/obj/effect/turf_decal/tile/purple/opposingcorners,
/obj/structure/disposalpipe/segment{
	dir = 4
	},
/turf/open/floor/iron,
/area/station/science/research)
"A" = (
/obj/item/kirbyplants/random,
/obj/effect/turf_decal/tile/purple/opposingcorners,
/obj/structure/window/reinforced/spawner/directional/north,
/turf/open/floor/iron,
/area/station/science/research)
"D" = (
/obj/effect/turf_decal/tile/purple/opposingcorners,
/obj/structure/window/reinforced/spawner/directional/north,
/obj/structure/disposalpipe/segment{
	dir = 6
	},
/turf/open/floor/iron,
/area/station/science/research)
"K" = (
/obj/structure/table,
/obj/effect/spawner/random/food_or_drink/donkpockets,
/obj/effect/turf_decal/tile/purple/opposingcorners,
/obj/machinery/light/small/directional/south,
/obj/structure/disposalpipe/segment{
	dir = 4
	},
/turf/open/floor/iron,
/area/station/science/research)
"L" = (
/obj/machinery/disposal/bin,
/obj/structure/disposalpipe/trunk,
/obj/effect/turf_decal/tile/purple/opposingcorners,
/obj/structure/window/reinforced/spawner/directional/north,
/turf/open/floor/iron,
/area/station/science/research)
"M" = (
/obj/structure/cable,
/obj/effect/turf_decal/tile/purple/opposingcorners,
/obj/structure/disposalpipe/segment{
	dir = 6
	},
/turf/open/floor/iron,
/area/station/science/research)
"N" = (
/obj/structure/cable,
/obj/machinery/atmospherics/components/unary/vent_pump/on/layer4{
	dir = 8
	},
/obj/effect/turf_decal/tile/purple/opposingcorners,
/obj/structure/disposalpipe/segment{
	dir = 9
	},
/turf/open/floor/iron,
/area/station/science/research)
"Z" = (
/obj/structure/cable,
/obj/machinery/atmospherics/pipe/smart/manifold4w/supply/hidden/layer4,
/obj/machinery/atmospherics/pipe/smart/manifold4w/scrubbers/hidden/layer2,
/obj/machinery/holopad,
/obj/effect/turf_decal/tile/purple/opposingcorners,
/obj/effect/landmark/event_spawn,
/turf/open/floor/iron,
/area/station/science/research)

(1,1,1) = {"
D
u
a
"}
(2,1,1) = {"
g
Z
s
"}
(3,1,1) = {"
t
i
v
"}
(4,1,1) = {"
L
N
K
"}
(5,1,1) = {"
A
M
e
"}
