//MAP CONVERTED BY dmm2tgm.py THIS HEADER COMMENT PREVENTS RECONVERSION, DO NOT REMOVE
"ar" = (
/obj/structure/table/wood/fancy,
/obj/structure/sign/painting/library{
	pixel_x = -32
	},
/turf/open/floor/wood,
/area/misc/hilbertshotel)
"aC" = (
/obj/effect/turf_decal/siding/wood/end{
	dir = 4
	},
/turf/open/floor/wood,
/area/misc/hilbertshotel)
"aS" = (
/obj/structure/bookcase/random/nonfiction,
/turf/open/floor/wood,
/area/misc/hilbertshotel)
"bw" = (
/obj/structure/sign/painting/large/library{
	pixel_y = -37
	},
/obj/effect/turf_decal/siding/wood{
	dir = 1
	},
/obj/effect/turf_decal/siding/wood,
/obj/item/kirbyplants/random,
/turf/open/floor/wood,
/area/misc/hilbertshotel)
"bz" = (
/obj/structure/chair/office{
	dir = 8
	},
/turf/open/floor/wood,
/area/misc/hilbertshotel)
"cy" = (
/obj/structure/easel,
/obj/effect/turf_decal/siding/wood{
	dir = 5
	},
/obj/effect/turf_decal/siding/wood/corner{
	dir = 8
	},
/obj/item/canvas/twentythree_twentythree,
/obj/item/canvas/twentythree_twentythree,
/obj/item/canvas/twentythree_nineteen,
/obj/item/canvas/fortyfive_twentyseven{
	pixel_x = 4;
	pixel_y = 4
	},
/obj/item/canvas/nineteen_nineteen,
/obj/structure/sign/painting/library{
	pixel_x = 32
	},
/turf/open/floor/wood,
/area/misc/hilbertshotel)
"cz" = (
/obj/structure/table/wood,
/obj/effect/turf_decal/siding/wood{
	dir = 1
	},
/obj/item/storage/dice{
	pixel_x = 8;
	pixel_y = 6
	},
/obj/item/storage/dice{
	pixel_x = -5;
	pixel_y = 6
	},
/turf/open/floor/carpet/black,
/area/misc/hilbertshotel)
"cD" = (
/obj/machinery/door/airlock/wood/glass,
/turf/open/floor/wood,
/area/misc/hilbertshotel)
"dw" = (
/obj/structure/table/wood,
/obj/item/stack/sheet/mineral/sandstone/thirty,
/obj/item/stack/sheet/mineral/gold,
/obj/item/stack/sheet/mineral/gold,
/obj/item/stack/sheet/mineral/silver,
/obj/item/stack/sheet/mineral/silver,
/obj/item/stack/sheet/mineral/gold,
/obj/item/stack/sheet/mineral/silver,
/obj/item/stack/sheet/mineral/diamond/five,
/turf/open/floor/iron/sepia,
/area/misc/hilbertshotel)
"dT" = (
/obj/effect/turf_decal/siding/wood/end{
	dir = 8
	},
/turf/open/floor/wood,
/area/misc/hilbertshotel)
"eO" = (
/turf/open/floor/carpet/red,
/area/misc/hilbertshotel)
"fa" = (
/turf/closed/indestructible/wood,
/area/misc/hilbertshotel)
"fi" = (
/obj/effect/turf_decal/siding/wood{
	dir = 9
	},
/obj/effect/turf_decal/siding/wood/corner,
/turf/open/floor/wood,
/area/misc/hilbertshotel)
"ga" = (
/obj/structure/table/wood,
/obj/item/paper_bin/carbon{
	pixel_y = 2;
	pixel_x = 6
	},
/obj/item/pen/fourcolor{
	pixel_x = 6;
	pixel_y = 2
	},
/turf/open/floor/iron/grimy,
/area/misc/hilbertshotel)
"gQ" = (
/obj/effect/turf_decal/siding/wood{
	dir = 1
	},
/obj/effect/turf_decal/siding/wood,
/turf/open/floor/wood,
/area/misc/hilbertshotel)
"ho" = (
/obj/effect/turf_decal/siding/wood{
	dir = 8
	},
/turf/open/floor/carpet/black,
/area/misc/hilbertshotel)
"ik" = (
/obj/structure/table/wood,
/obj/machinery/computer/libraryconsole/bookmanagement,
/obj/effect/turf_decal/siding/wood,
/obj/effect/turf_decal/siding/wood{
	dir = 1
	},
/turf/open/floor/iron/grimy,
/area/misc/hilbertshotel)
"jr" = (
/obj/structure/bookcase/random/fiction,
/turf/open/floor/wood,
/area/misc/hilbertshotel)
"jx" = (
/obj/structure/table/wood,
/obj/item/pen/fourcolor,
/turf/open/floor/wood,
/area/misc/hilbertshotel)
"kD" = (
/obj/effect/turf_decal/siding/wood{
	dir = 9
	},
/turf/open/floor/carpet/black,
/area/misc/hilbertshotel)
"kS" = (
/obj/effect/turf_decal/siding/wood{
	dir = 8
	},
/obj/structure/chair/comfy/brown{
	buildstackamount = 0;
	color = "#c45c57";
	dir = 8;
	pixel_y = -8
	},
/turf/open/floor/carpet/black,
/area/misc/hilbertshotel)
"kW" = (
/obj/machinery/vending/games,
/obj/structure/sign/painting/library{
	pixel_y = 33
	},
/obj/effect/turf_decal/siding/wood{
	dir = 9
	},
/obj/effect/turf_decal/siding/wood/corner,
/turf/open/floor/wood,
/area/misc/hilbertshotel)
"lv" = (
/obj/effect/turf_decal/siding/wood/end{
	dir = 4
	},
/turf/open/floor/iron/grimy,
/area/misc/hilbertshotel)
"lY" = (
/obj/machinery/photocopier,
/obj/effect/turf_decal/siding/wood,
/obj/effect/turf_decal/siding/wood{
	dir = 1
	},
/turf/open/floor/wood,
/area/misc/hilbertshotel)
"md" = (
/obj/structure/table/wood,
/obj/effect/turf_decal/siding/wood/end,
/obj/item/paper_bin/carbon{
	pixel_x = -6
	},
/obj/item/paper_bin/carbon{
	pixel_x = 7
	},
/turf/open/floor/iron/grimy,
/area/misc/hilbertshotel)
"mK" = (
/obj/structure/bookcase/random/religion,
/turf/open/floor/wood,
/area/misc/hilbertshotel)
"nA" = (
/obj/structure/chair/comfy/beige{
	dir = 4
	},
/obj/effect/turf_decal/siding/wood/end{
	dir = 8
	},
/turf/open/floor/wood,
/area/misc/hilbertshotel)
"oZ" = (
/obj/effect/turf_decal/siding/wood{
	dir = 1
	},
/obj/structure/chair/office,
/turf/open/floor/wood,
/area/misc/hilbertshotel)
"pm" = (
/obj/structure/chair/comfy/brown{
	dir = 4
	},
/obj/effect/turf_decal/siding/wood,
/turf/open/floor/wood,
/area/misc/hilbertshotel)
"pv" = (
/obj/effect/turf_decal/siding/wood,
/obj/effect/turf_decal/siding/wood{
	dir = 1
	},
/obj/structure/chair/office,
/turf/open/floor/wood,
/area/misc/hilbertshotel)
"qn" = (
/obj/structure/table/wood,
/turf/open/floor/wood,
/area/misc/hilbertshotel)
"rW" = (
/obj/machinery/modular_computer/preset/curator{
	dir = 1
	},
/obj/machinery/light/directional/east,
/turf/open/floor/carpet/green,
/area/misc/hilbertshotel)
"st" = (
/obj/structure/table/wood,
/obj/effect/turf_decal/siding/wood,
/obj/item/toy/figure/wizard{
	pixel_y = -2;
	pixel_x = -8
	},
/obj/item/toy/figure/ninja{
	pixel_y = -2
	},
/obj/item/toy/figure/secofficer{
	pixel_y = -2;
	pixel_x = 8
	},
/obj/item/toy/figure/cmo{
	pixel_y = 13
	},
/obj/item/toy/figure/curator{
	pixel_y = 13;
	pixel_x = 8
	},
/turf/open/floor/carpet/black,
/area/misc/hilbertshotel)
"tK" = (
/obj/effect/turf_decal/siding/wood/end{
	dir = 8
	},
/obj/machinery/room_controller/directional/west,
/turf/open/floor/wood,
/area/misc/hilbertshotel)
"tN" = (
/obj/effect/turf_decal/siding/wood{
	dir = 4
	},
/obj/effect/turf_decal/siding/wood{
	dir = 8
	},
/obj/machinery/light/small/dim/directional/west,
/turf/open/floor/wood,
/area/misc/hilbertshotel)
"uX" = (
/obj/structure/table/wood,
/obj/item/reagent_containers/cup/glass/coffee,
/turf/open/floor/wood,
/area/misc/hilbertshotel)
"wl" = (
/obj/structure/chair/comfy/beige{
	dir = 8
	},
/obj/effect/turf_decal/siding/wood,
/obj/effect/turf_decal/siding/wood{
	dir = 1
	},
/turf/open/floor/wood,
/area/misc/hilbertshotel)
"wu" = (
/obj/item/kirbyplants/random,
/turf/open/floor/iron/grimy,
/area/misc/hilbertshotel)
"wS" = (
/obj/structure/table/wood,
/turf/open/floor/carpet/red,
/area/misc/hilbertshotel)
"zY" = (
/obj/structure/table/wood,
/obj/effect/turf_decal/siding/wood{
	dir = 9
	},
/obj/effect/turf_decal/siding/wood/corner,
/turf/open/floor/iron/grimy,
/area/misc/hilbertshotel)
"AE" = (
/obj/structure/table/wood,
/obj/effect/turf_decal/siding/wood,
/obj/effect/turf_decal/siding/wood{
	dir = 1
	},
/obj/item/reagent_containers/cup/glass/coffee,
/turf/open/floor/wood,
/area/misc/hilbertshotel)
"AO" = (
/obj/effect/turf_decal/siding/wood,
/turf/open/floor/wood,
/area/misc/hilbertshotel)
"Bm" = (
/obj/structure/table/wood/fancy,
/obj/effect/spawner/random/decoration/statue{
	spawn_loot_chance = 35
	},
/obj/structure/sign/painting/library{
	pixel_x = -32
	},
/obj/machinery/light/directional/south,
/turf/open/floor/wood,
/area/misc/hilbertshotel)
"BF" = (
/obj/structure/bookcase/random/adult,
/turf/open/floor/wood,
/area/misc/hilbertshotel)
"Dc" = (
/turf/open/floor/wood,
/area/misc/hilbertshotel)
"DX" = (
/obj/machinery/bookbinder,
/obj/effect/turf_decal/siding/wood,
/obj/effect/turf_decal/siding/wood{
	dir = 1
	},
/turf/open/floor/wood,
/area/misc/hilbertshotel)
"Ea" = (
/obj/structure/table/wood,
/obj/item/paper_bin/carbon{
	pixel_y = 1
	},
/obj/item/pen,
/turf/open/floor/carpet/black,
/area/misc/hilbertshotel)
"EF" = (
/obj/machinery/bookbinder,
/obj/machinery/light/directional/south,
/turf/open/floor/carpet/red,
/area/misc/hilbertshotel)
"EX" = (
/obj/effect/turf_decal/siding/wood,
/obj/effect/turf_decal/siding/wood{
	dir = 1
	},
/obj/structure/chair/office{
	dir = 1
	},
/turf/open/floor/wood,
/area/misc/hilbertshotel)
"Fo" = (
/turf/closed/indestructible/rock,
/area/misc/hilbertshotel)
"FN" = (
/turf/open/floor/iron/sepia,
/area/misc/hilbertshotel)
"Gv" = (
/obj/effect/turf_decal/siding/wood{
	dir = 1
	},
/obj/effect/turf_decal/siding/wood,
/obj/structure/chair/office{
	dir = 1
	},
/turf/open/floor/wood,
/area/misc/hilbertshotel)
"HB" = (
/obj/structure/table/wood,
/obj/effect/turf_decal/siding/wood,
/obj/effect/spawner/random/entertainment/money_large,
/obj/effect/spawner/random/entertainment/money_large,
/obj/machinery/light/directional/south,
/turf/open/floor/wood,
/area/misc/hilbertshotel)
"HL" = (
/obj/structure/sign/painting/library{
	pixel_y = -32
	},
/obj/effect/turf_decal/siding/wood{
	dir = 1
	},
/obj/effect/turf_decal/siding/wood,
/turf/open/floor/wood,
/area/misc/hilbertshotel)
"HO" = (
/obj/effect/turf_decal/siding/wood,
/obj/effect/turf_decal/siding/wood{
	dir = 1
	},
/obj/structure/sign/painting/large/library{
	dir = 1
	},
/obj/item/kirbyplants/random,
/turf/open/floor/wood,
/area/misc/hilbertshotel)
"Ib" = (
/obj/structure/table/wood,
/obj/effect/turf_decal/siding/wood{
	dir = 8
	},
/obj/effect/turf_decal/siding/wood{
	dir = 4
	},
/obj/item/pen/fountain,
/turf/open/floor/iron/grimy,
/area/misc/hilbertshotel)
"Ix" = (
/obj/structure/table/wood,
/obj/item/papercutter{
	pixel_x = 4;
	pixel_y = 4
	},
/obj/item/storage/crayons{
	pixel_x = 1;
	pixel_y = -1
	},
/obj/item/storage/crayons{
	pixel_x = -2;
	pixel_y = -5
	},
/obj/item/wirecutters,
/turf/open/floor/carpet/blue,
/area/misc/hilbertshotel)
"IB" = (
/obj/structure/table/wood,
/obj/item/paper_bin/carbon{
	pixel_y = 2;
	pixel_x = 6
	},
/obj/item/pen/fountain{
	pixel_y = -2;
	pixel_x = -9
	},
/obj/item/pen{
	pixel_x = 6;
	pixel_y = 3
	},
/obj/machinery/light/directional/north,
/turf/open/floor/iron/grimy,
/area/misc/hilbertshotel)
"Je" = (
/obj/structure/chair/comfy/brown{
	dir = 8
	},
/obj/effect/turf_decal/siding/wood,
/turf/open/floor/wood,
/area/misc/hilbertshotel)
"JI" = (
/obj/effect/turf_decal/siding/wood/corner{
	dir = 1
	},
/obj/effect/turf_decal/siding/wood{
	dir = 6
	},
/obj/structure/sign/painting/library{
	pixel_x = 32
	},
/obj/machinery/vending/dorms,
/turf/open/floor/wood,
/area/misc/hilbertshotel)
"JO" = (
/obj/machinery/libraryscanner,
/turf/open/floor/carpet/green,
/area/misc/hilbertshotel)
"JW" = (
/obj/effect/turf_decal/siding/wood,
/obj/effect/turf_decal/siding/wood{
	dir = 1
	},
/turf/open/floor/wood,
/area/misc/hilbertshotel)
"Kd" = (
/obj/structure/easel,
/obj/effect/turf_decal/siding/wood{
	dir = 4
	},
/obj/effect/turf_decal/siding/wood{
	dir = 8
	},
/obj/item/canvas/twentythree_twentythree,
/obj/item/canvas/twentythree_twentythree,
/obj/item/canvas/twentythree_nineteen,
/obj/item/canvas/fortyfive_twentyseven{
	pixel_x = 4;
	pixel_y = 4
	},
/obj/item/canvas/nineteen_nineteen,
/obj/machinery/light/directional/east,
/turf/open/floor/wood,
/area/misc/hilbertshotel)
"Lv" = (
/obj/structure/table/wood/fancy,
/obj/effect/spawner/random/decoration/statue{
	spawn_loot_chance = 35
	},
/obj/structure/sign/painting/library{
	pixel_x = -32
	},
/obj/machinery/light/directional/north,
/turf/open/floor/wood,
/area/misc/hilbertshotel)
"LC" = (
/obj/effect/turf_decal/siding/wood{
	dir = 8
	},
/turf/open/floor/wood,
/area/misc/hilbertshotel)
"LI" = (
/obj/effect/turf_decal/siding/wood{
	dir = 1
	},
/obj/effect/turf_decal/siding/wood,
/obj/structure/chair/office{
	dir = 1
	},
/obj/machinery/light/small/dim/directional/south,
/turf/open/floor/wood,
/area/misc/hilbertshotel)
"Mf" = (
/obj/machinery/computer/libraryconsole/bookmanagement,
/obj/structure/table/wood,
/turf/open/floor/iron/grimy,
/area/misc/hilbertshotel)
"Mk" = (
/obj/structure/table/wood,
/obj/item/paper_bin/carbon{
	pixel_y = 10;
	pixel_x = -8
	},
/obj/item/pen{
	pixel_y = 10;
	pixel_x = -7
	},
/turf/open/floor/wood,
/area/misc/hilbertshotel)
"Mp" = (
/obj/structure/sign/painting/library{
	pixel_y = -32
	},
/obj/effect/turf_decal/siding/wood{
	dir = 10
	},
/obj/effect/turf_decal/siding/wood/corner{
	dir = 4
	},
/turf/open/floor/wood,
/area/misc/hilbertshotel)
"MO" = (
/obj/machinery/vending/coffee{
	default_price = 0
	},
/turf/open/floor/carpet/red,
/area/misc/hilbertshotel)
"Nl" = (
/obj/structure/table/wood,
/obj/item/paper_bin/carbon{
	pixel_y = -7
	},
/obj/item/pen/fourcolor{
	pixel_y = -7
	},
/obj/machinery/light/directional/east,
/turf/open/floor/carpet/black,
/area/misc/hilbertshotel)
"Np" = (
/obj/structure/table/wood,
/obj/item/dice/d20{
	pixel_y = -10
	},
/turf/open/floor/carpet/red,
/area/misc/hilbertshotel)
"NX" = (
/obj/effect/turf_decal/siding/wood,
/obj/effect/turf_decal/siding/wood,
/obj/structure/chair/office,
/turf/open/floor/wood,
/area/misc/hilbertshotel)
"Py" = (
/turf/open/floor/iron/grimy,
/area/misc/hilbertshotel)
"PK" = (
/obj/effect/turf_decal/siding/wood{
	dir = 10
	},
/turf/open/floor/carpet/black,
/area/misc/hilbertshotel)
"Rx" = (
/obj/structure/displaycase/trophy,
/turf/open/floor/carpet/red,
/area/misc/hilbertshotel)
"RM" = (
/obj/effect/spawner/structure/window,
/turf/open/floor/plating,
/area/misc/hilbertshotel)
"RP" = (
/obj/structure/chair/office{
	dir = 8
	},
/turf/open/floor/carpet/green,
/area/misc/hilbertshotel)
"Tj" = (
/obj/structure/chair/office{
	dir = 4
	},
/obj/effect/turf_decal/siding/wood{
	dir = 8
	},
/turf/open/floor/wood,
/area/misc/hilbertshotel)
"Tu" = (
/obj/effect/turf_decal/siding/wood{
	dir = 4
	},
/obj/effect/turf_decal/siding/wood{
	dir = 8
	},
/turf/open/floor/wood,
/area/misc/hilbertshotel)
"Ul" = (
/obj/structure/table/wood,
/obj/effect/turf_decal/siding/wood{
	dir = 8
	},
/obj/effect/turf_decal/siding/wood{
	dir = 4
	},
/obj/item/toy/eldritch_book,
/turf/open/floor/iron/grimy,
/area/misc/hilbertshotel)
"UQ" = (
/obj/structure/table/wood,
/obj/item/toy/crayon/spraycan{
	pixel_x = 4;
	pixel_y = 8
	},
/obj/item/chisel{
	pixel_x = -15;
	pixel_y = 6
	},
/obj/item/toy/crayon/spraycan{
	pixel_x = -4;
	pixel_y = 8
	},
/obj/item/toy/crayon/spraycan{
	pixel_y = 6
	},
/obj/item/paint_palette,
/turf/open/floor/carpet/blue,
/area/misc/hilbertshotel)
"Wh" = (
/turf/open/floor/carpet/green,
/area/misc/hilbertshotel)
"Wl" = (
/obj/machinery/door/airlock/wood,
/turf/open/floor/wood,
/area/misc/hilbertshotel)
"Wp" = (
/obj/structure/fireplace{
	pixel_y = 0;
	pixel_x = 0
	},
/obj/effect/turf_decal/siding/wood{
	dir = 1
	},
/obj/effect/turf_decal/siding/wood,
/obj/structure/chair/office,
/obj/machinery/light/small/dim/directional/north,
/turf/open/floor/wood,
/area/misc/hilbertshotel)
"Wt" = (
/obj/effect/turf_decal/siding/wood{
	dir = 10
	},
/obj/effect/turf_decal/siding/wood/corner{
	dir = 4
	},
/turf/open/floor/wood,
/area/misc/hilbertshotel)
"WI" = (
/obj/effect/turf_decal/siding/wood{
	dir = 1
	},
/obj/effect/turf_decal/siding/wood/corner{
	dir = 8
	},
/turf/open/floor/wood,
/area/misc/hilbertshotel)
"WN" = (
/obj/effect/turf_decal/siding/wood{
	dir = 1
	},
/turf/open/floor/wood,
/area/misc/hilbertshotel)
"WX" = (
/obj/structure/sign/painting/large/library{
	pixel_y = -37
	},
/obj/effect/turf_decal/siding/wood{
	dir = 1
	},
/obj/effect/turf_decal/siding/wood,
/turf/open/floor/wood,
/area/misc/hilbertshotel)
"YW" = (
/turf/closed/indestructible/hoteldoor{
	icon_state = "door_closed";
	icon = 'icons/obj/doors/puzzledoor/default.dmi'
	},
/area/misc/hilbertshotel)
"Zq" = (
/obj/effect/turf_decal/siding/wood,
/obj/effect/turf_decal/siding/wood/corner{
	dir = 1
	},
/turf/open/floor/wood,
/area/misc/hilbertshotel)
"ZS" = (
/obj/machinery/photocopier,
/obj/machinery/light/directional/north,
/turf/open/floor/iron/grimy,
/area/misc/hilbertshotel)

(1,1,1) = {"
Fo
Fo
Fo
Fo
fa
fa
YW
fa
fa
fa
fa
fa
fa
fa
fa
"}
(2,1,1) = {"
fa
fa
fa
fa
fa
MO
eO
EF
fa
fa
Lv
ar
ar
Bm
fa
"}
(3,1,1) = {"
fa
BF
dT
jr
tK
eO
eO
eO
nA
fa
kW
Tu
Tu
Mp
fa
"}
(4,1,1) = {"
fa
BF
gQ
jr
gQ
eO
Rx
eO
AE
RM
DX
FN
dw
WX
fa
"}
(5,1,1) = {"
fa
BF
gQ
jr
gQ
eO
Rx
eO
wl
RM
lY
FN
Ix
gQ
fa
"}
(6,1,1) = {"
fa
Mf
gQ
wu
gQ
eO
eO
eO
JW
cD
JW
FN
UQ
HL
fa
"}
(7,1,1) = {"
fa
IB
gQ
Py
WI
Tj
Tj
LC
Zq
fa
HO
FN
FN
bw
fa
"}
(8,1,1) = {"
fa
BF
gQ
jr
oZ
uX
qn
Dc
pm
fa
cy
Kd
Tu
JI
fa
"}
(9,1,1) = {"
fa
BF
gQ
jr
oZ
jx
Mk
Dc
HB
fa
fa
fa
Wl
fa
fa
"}
(10,1,1) = {"
fa
BF
gQ
jr
WN
bz
bz
Dc
Je
fa
fi
tN
Tu
Wt
fa
"}
(11,1,1) = {"
fa
ga
gQ
Py
WN
Dc
Dc
Dc
AO
Wl
pv
wS
wS
Gv
fa
"}
(12,1,1) = {"
fa
ZS
gQ
wu
WN
zY
Ul
Ib
md
fa
Wp
Np
wS
LI
fa
"}
(13,1,1) = {"
fa
mK
gQ
aS
WN
ik
RP
Wh
JO
fa
NX
wS
wS
EX
fa
"}
(14,1,1) = {"
fa
mK
gQ
aS
WN
lv
Wh
Wh
rW
fa
kD
kS
ho
PK
fa
"}
(15,1,1) = {"
fa
mK
aC
aS
aC
fa
fa
fa
fa
fa
cz
Nl
Ea
st
fa
"}
(16,1,1) = {"
fa
fa
fa
fa
fa
fa
Fo
Fo
Fo
fa
fa
fa
fa
fa
fa
"}
