//MAP CONVERTED BY dmm2tgm.py THIS HEADER COMMENT PREVENTS RECONVERSION, DO NOT REMOVE
"af" = (
/turf/open/floor/wood/tile,
/area/misc/hilbertshotel)
"cK" = (
/turf/open/floor/carpet/black,
/area/misc/hilbertshotel)
"dy" = (
/obj/structure/chair/stool/bar,
/turf/open/floor/carpet/black,
/area/misc/hilbertshotel)
"dR" = (
/obj/effect/turf_decal/siding/wood{
	dir = 1
	},
/obj/structure/table/wood/fancy/royalblack,
/obj/item/storage/fancy/heart_box,
/turf/open/floor/wood/tile,
/area/misc/hilbertshotel)
"ee" = (
/turf/open/floor/carpet/royalblack,
/area/misc/hilbertshotel)
"fo" = (
/obj/machinery/vending/boozeomat{
	shut_up = 1
	},
/turf/open/floor/wood/tile,
/area/misc/hilbertshotel)
"hi" = (
/obj/structure/chair/stool/bar{
	dir = 1
	},
/turf/open/floor/carpet/royalblack,
/area/misc/hilbertshotel)
"jj" = (
/obj/structure/mirror,
/turf/closed/indestructible/steel,
/area/misc/hilbertshotel)
"kp" = (
/obj/structure/table/wood,
/obj/machinery/light{
	dir = 4
	},
/turf/open/floor/carpet/royalblack,
/area/misc/hilbertshotel)
"kr" = (
/obj/effect/turf_decal/siding/wood,
/obj/structure/chair/stool/bar{
	dir = 1
	},
/turf/open/floor/carpet/royalblack,
/area/misc/hilbertshotel)
"kB" = (
/obj/item/toy/cards/deck,
/obj/structure/table/wood/fancy/purple,
/turf/open/floor/carpet/royalblack,
/area/misc/hilbertshotel)
"kC" = (
/obj/structure/table/wood,
/obj/machinery/light{
	dir = 4
	},
/obj/structure/sign/poster/contraband/random{
	pixel_x = 32
	},
/turf/open/floor/carpet/royalblack,
/area/misc/hilbertshotel)
"kQ" = (
/turf/closed/indestructible/hoteldoor{
	icon_state = "door_closed";
	icon = 'icons/obj/doors/puzzledoor/default.dmi'
	},
/area/misc/hilbertshotel)
"li" = (
/obj/structure/table/wood,
/obj/item/reagent_containers/cup/glass/drinkingglass,
/obj/item/reagent_containers/cup/glass/shaker{
	pixel_x = -10;
	pixel_y = 12
	},
/obj/item/reagent_containers/cup/glass/shaker{
	pixel_x = -10
	},
/turf/open/floor/wood/tile,
/area/misc/hilbertshotel)
"lS" = (
/obj/structure/table/wood,
/obj/machinery/chem_dispenser/drinks{
	dir = 1
	},
/turf/open/floor/wood/tile,
/area/misc/hilbertshotel)
"lT" = (
/obj/machinery/light_switch/directional/east,
/turf/open/indestructible/hoteltile,
/area/misc/hilbertshotel)
"nj" = (
/obj/effect/turf_decal/siding/wood,
/obj/structure/table/wood/fancy/purple,
/turf/open/floor/carpet/royalblack,
/area/misc/hilbertshotel)
"nQ" = (
/obj/effect/turf_decal/siding/wood{
	dir = 1
	},
/obj/structure/table/wood/fancy/royalblack,
/turf/open/floor/wood/tile,
/area/misc/hilbertshotel)
"oH" = (
/obj/structure/table/wood,
/obj/machinery/chem_dispenser/drinks/beer{
	dir = 1
	},
/turf/open/floor/wood/tile,
/area/misc/hilbertshotel)
"pr" = (
/obj/structure/chair/stool/bar,
/turf/open/floor/carpet/royalblack,
/area/misc/hilbertshotel)
"qn" = (
/obj/machinery/light{
	dir = 1
	},
/turf/open/floor/carpet/royalblack,
/area/misc/hilbertshotel)
"qQ" = (
/obj/structure/table/wood/fancy/purple,
/turf/open/floor/carpet/royalblack,
/area/misc/hilbertshotel)
"rY" = (
/obj/structure/sign/poster/random,
/turf/closed/indestructible/steel,
/area/misc/hilbertshotel)
"sm" = (
/obj/effect/turf_decal/siding/wood,
/turf/open/floor/carpet/royalblack,
/area/misc/hilbertshotel)
"sU" = (
/obj/structure/sink/directional/south,
/obj/structure/urinal/directional/east,
/turf/open/indestructible/hoteltile,
/area/misc/hilbertshotel)
"sY" = (
/obj/structure/table/wood,
/obj/effect/turf_decal/siding/wood{
	dir = 8
	},
/turf/open/floor/carpet/royalblack,
/area/misc/hilbertshotel)
"te" = (
/obj/machinery/door/morgue,
/turf/open/indestructible/hoteltile,
/area/misc/hilbertshotel)
"tl" = (
/obj/structure/sink/directional/south,
/obj/structure/urinal/directional/west,
/turf/open/indestructible/hoteltile,
/area/misc/hilbertshotel)
"tx" = (
/obj/machinery/door/window/survival_pod{
	dir = 4
	},
/turf/open/floor/carpet/royalblack,
/area/misc/hilbertshotel)
"ut" = (
/obj/structure/window{
	dir = 1;
	icon_state = "window"
	},
/obj/effect/turf_decal/siding/wood{
	dir = 8
	},
/obj/structure/chair/sofa/corp/right{
	color = "#DE3A3A"
	},
/turf/open/floor/carpet/royalblack,
/area/misc/hilbertshotel)
"vU" = (
/obj/machinery/telecomms/relay/preset/auto,
/turf/open/floor/catwalk_floor,
/area/misc/hilbertshotel)
"vW" = (
/obj/structure/table/wood,
/turf/open/floor/carpet/royalblack,
/area/misc/hilbertshotel)
"wB" = (
/obj/machinery/computer/slot_machine,
/turf/open/floor/carpet/royalblack,
/area/misc/hilbertshotel)
"xI" = (
/obj/structure/window{
	dir = 1;
	icon_state = "window"
	},
/obj/structure/chair/sofa/corp{
	color = "#DE3A3A"
	},
/turf/open/floor/carpet/royalblack,
/area/misc/hilbertshotel)
"yz" = (
/turf/open/floor/glass/reinforced,
/area/misc/hilbertshotel)
"yO" = (
/obj/effect/turf_decal/siding/wood,
/obj/item/choice_beacon/box/plushie,
/obj/structure/table/wood/fancy/purple,
/turf/open/floor/carpet/royalblack,
/area/misc/hilbertshotel)
"BL" = (
/obj/machinery/light{
	dir = 8
	},
/turf/open/indestructible/hoteltile,
/area/misc/hilbertshotel)
"CL" = (
/obj/effect/turf_decal/siding/wood{
	dir = 4
	},
/obj/structure/window/reinforced/survival_pod{
	dir = 4
	},
/turf/open/floor/wood/tile,
/area/misc/hilbertshotel)
"DV" = (
/obj/machinery/light{
	dir = 1
	},
/obj/structure/toilet,
/turf/open/indestructible/hoteltile,
/area/misc/hilbertshotel)
"EI" = (
/obj/effect/turf_decal/siding/wood{
	dir = 4
	},
/obj/effect/turf_decal/siding/wood{
	dir = 1
	},
/obj/structure/table/wood/fancy/royalblack,
/turf/open/floor/wood/tile,
/area/misc/hilbertshotel)
"Fz" = (
/obj/structure/window{
	dir = 1;
	icon_state = "window"
	},
/obj/structure/chair/sofa/corp/left{
	color = "#DE3A3A"
	},
/turf/open/floor/carpet/royalblack,
/area/misc/hilbertshotel)
"FA" = (
/obj/structure/window{
	dir = 1
	},
/obj/effect/turf_decal/siding/wood{
	dir = 8
	},
/obj/structure/chair/sofa/corp/right{
	color = "#DE3A3A"
	},
/turf/open/floor/carpet/royalblack,
/area/misc/hilbertshotel)
"GV" = (
/turf/open/indestructible/hoteltile,
/area/misc/hilbertshotel)
"Hs" = (
/obj/structure/window,
/obj/structure/chair/sofa/corp/left{
	color = "#DE3A3A";
	dir = 1
	},
/obj/effect/turf_decal/siding/wood{
	dir = 8
	},
/turf/open/floor/carpet/royalblack,
/area/misc/hilbertshotel)
"Hy" = (
/obj/structure/window,
/obj/structure/chair/sofa/corp/right{
	color = "#DE3A3A";
	dir = 1
	},
/turf/open/floor/carpet/royalblack,
/area/misc/hilbertshotel)
"Ik" = (
/obj/structure/window{
	dir = 1
	},
/obj/structure/chair/sofa/corp{
	color = "#DE3A3A"
	},
/turf/open/floor/carpet/royalblack,
/area/misc/hilbertshotel)
"Ji" = (
/obj/machinery/jukebox/disco{
	anchored = 1;
	req_one_access = null;
	area_limited = 1
	},
/turf/open/floor/carpet/black,
/area/misc/hilbertshotel)
"Jn" = (
/obj/structure/sign/poster/random,
/turf/closed/wall,
/area/misc/hilbertshotel)
"Mr" = (
/obj/machinery/light{
	dir = 1
	},
/obj/machinery/vending/games{
	shut_up = 1
	},
/turf/open/floor/carpet/black,
/area/misc/hilbertshotel)
"Mz" = (
/obj/structure/window{
	dir = 1
	},
/obj/structure/chair/sofa/corp/left{
	color = "#DE3A3A"
	},
/turf/open/floor/carpet/royalblack,
/area/misc/hilbertshotel)
"MV" = (
/turf/closed/wall,
/area/misc/hilbertshotel)
"OA" = (
/obj/structure/chair/sofa/corp/right{
	color = "#DE3A3A";
	dir = 1
	},
/turf/open/floor/carpet/royalblack,
/area/misc/hilbertshotel)
"Pz" = (
/obj/machinery/light_switch/directional/west,
/obj/structure/sink/kitchen/directional/east,
/turf/open/floor/wood/tile,
/area/misc/hilbertshotel)
"PG" = (
/obj/machinery/smartfridge/drinks,
/turf/closed/indestructible/steel,
/area/misc/hilbertshotel)
"PJ" = (
/obj/structure/window,
/obj/structure/chair/sofa/corp{
	color = "#DE3A3A";
	dir = 1
	},
/turf/open/floor/carpet/royalblack,
/area/misc/hilbertshotel)
"QC" = (
/obj/structure/sign/poster/contraband/random,
/turf/closed/wall,
/area/misc/hilbertshotel)
"QE" = (
/obj/effect/turf_decal/siding/wood{
	dir = 4
	},
/obj/machinery/door/window/survival_pod{
	dir = 4
	},
/obj/machinery/light,
/turf/open/floor/wood/tile,
/area/misc/hilbertshotel)
"RL" = (
/obj/structure/lattice,
/turf/open/space/bluespace,
/area/misc/hilbertshotel)
"SW" = (
/obj/structure/sign/poster/contraband/random,
/turf/closed/indestructible/steel,
/area/misc/hilbertshotel)
"Tk" = (
/obj/structure/table,
/obj/structure/bedsheetbin,
/turf/open/indestructible/hoteltile,
/area/misc/hilbertshotel)
"Tx" = (
/obj/structure/chair/sofa/corp{
	color = "#DE3A3A";
	dir = 1
	},
/turf/open/floor/carpet/royalblack,
/area/misc/hilbertshotel)
"TA" = (
/obj/machinery/light{
	dir = 8
	},
/turf/open/floor/wood/tile,
/area/misc/hilbertshotel)
"UE" = (
/obj/effect/turf_decal/siding/wood{
	dir = 1
	},
/obj/structure/table/wood/fancy/royalblack,
/obj/effect/spawner/random/food_or_drink/three_course_meal,
/turf/open/floor/wood/tile,
/area/misc/hilbertshotel)
"UR" = (
/obj/effect/turf_decal/siding/wood{
	dir = 4
	},
/obj/structure/window/reinforced/survival_pod{
	dir = 4
	},
/obj/structure/table/wood/fancy/royalblack,
/turf/open/floor/wood/tile,
/area/misc/hilbertshotel)
"We" = (
/obj/machinery/vending/snack/teal,
/turf/open/floor/carpet/black,
/area/misc/hilbertshotel)
"Wg" = (
/obj/machinery/light{
	dir = 8
	},
/turf/open/floor/carpet/black,
/area/misc/hilbertshotel)
"WO" = (
/obj/structure/table,
/turf/open/indestructible/hoteltile,
/area/misc/hilbertshotel)
"Xr" = (
/turf/open/space/bluespace,
/area/misc/hilbertshotel)
"Zn" = (
/obj/structure/chair/sofa/corp/left{
	color = "#DE3A3A";
	dir = 1
	},
/obj/effect/turf_decal/siding/wood{
	dir = 8
	},
/turf/open/floor/carpet/royalblack,
/area/misc/hilbertshotel)
"ZE" = (
/turf/closed/indestructible/steel,
/area/misc/hilbertshotel)

(1,1,1) = {"
Xr
Xr
Xr
Xr
Xr
Xr
Xr
Xr
Xr
Xr
Xr
Xr
Xr
Xr
Xr
Xr
"}
(2,1,1) = {"
Xr
Xr
ZE
ZE
SW
ZE
ZE
ZE
kQ
ZE
ZE
rY
ZE
SW
ZE
Xr
"}
(3,1,1) = {"
Xr
vU
rY
ee
ee
pr
yO
Wg
yz
dy
nQ
TA
Pz
li
ZE
Xr
"}
(4,1,1) = {"
Xr
RL
ZE
tx
kB
qQ
nj
cK
yz
dy
nQ
af
af
lS
ZE
Xr
"}
(5,1,1) = {"
Xr
RL
SW
qn
hi
hi
kr
cK
yz
dy
dR
af
af
oH
rY
Xr
"}
(6,1,1) = {"
Xr
RL
ZE
ee
ee
ee
sm
cK
yz
dy
UE
af
af
fo
ZE
Xr
"}
(7,1,1) = {"
Xr
RL
rY
wB
hi
ee
sm
cK
yz
dy
nQ
af
af
af
PG
Xr
"}
(8,1,1) = {"
Xr
Xr
ZE
MV
MV
MV
MV
Ji
yz
dy
EI
UR
CL
QE
rY
Xr
"}
(9,1,1) = {"
Xr
Xr
jj
tl
BL
GV
te
cK
yz
cK
cK
cK
cK
cK
ZE
Xr
"}
(10,1,1) = {"
Xr
Xr
jj
sU
lT
GV
MV
Mr
yz
yz
yz
yz
yz
yz
ZE
Xr
"}
(11,1,1) = {"
Xr
Xr
ZE
MV
QC
GV
MV
We
cK
cK
cK
cK
cK
cK
ZE
Xr
"}
(12,1,1) = {"
Xr
Xr
ZE
DV
te
GV
MV
Jn
ut
sY
Hs
FA
sY
Zn
SW
Xr
"}
(13,1,1) = {"
Xr
Xr
ZE
MV
MV
GV
Tk
MV
xI
vW
PJ
Ik
vW
Tx
ZE
Xr
"}
(14,1,1) = {"
Xr
Xr
ZE
DV
te
GV
WO
QC
Fz
kp
Hy
Mz
kC
OA
rY
Xr
"}
(15,1,1) = {"
Xr
Xr
ZE
ZE
ZE
rY
ZE
ZE
ZE
rY
ZE
ZE
ZE
ZE
ZE
Xr
"}
(16,1,1) = {"
Xr
Xr
Xr
Xr
Xr
Xr
Xr
Xr
Xr
Xr
Xr
Xr
Xr
Xr
Xr
Xr
"}
