//MAP CONVERTED BY dmm2tgm.py THIS HEADER COMMENT PREVENTS RECONVERSION, DO NOT REMOVE
"aV" = (
/obj/structure/flora/rock/pile/jungle/style_random,
/turf/open/misc/grass/jungle/station,
/area/misc/hilbertshotel)
"bn" = (
/obj/structure/flora/grass/jungle/b/style_random,
/obj/structure/flora/bush/jungle/c/style_random,
/obj/structure/flora/rock/pile/jungle/style_random,
/turf/open/misc/grass/jungle/station,
/area/misc/hilbertshotel)
"bt" = (
/obj/structure/chair/sofa/corp/corner{
	dir = 1
	},
/obj/effect/turf_decal/siding/wood{
	dir = 10
	},
/turf/open/floor/carpet/green,
/area/misc/hilbertshotel)
"bU" = (
/obj/structure/railing{
	dir = 1
	},
/turf/open/indestructible/cobble/corner{
	dir = 1
	},
/area/misc/hilbertshotel)
"cg" = (
/obj/machinery/light{
	dir = 4
	},
/turf/open/water,
/area/misc/hilbertshotel)
"cp" = (
/obj/structure/chair/pew,
/turf/open/misc/grass/jungle/station,
/area/misc/hilbertshotel)
"cA" = (
/obj/machinery/light/small{
	dir = 1
	},
/obj/structure/railing{
	dir = 1
	},
/turf/open/indestructible/cobble/corner,
/area/misc/hilbertshotel)
"cC" = (
/obj/machinery/light/floor{
	light_power = 20;
	light_range = 5
	},
/obj/structure/flora/bush/jungle/a/style_random,
/obj/structure/flora/rock/pile/jungle/style_random,
/turf/open/misc/dirt/station,
/area/misc/hilbertshotel)
"dl" = (
/turf/open/floor/wood,
/area/misc/hilbertshotel)
"dQ" = (
/obj/structure/chair/sofa/corp{
	dir = 1
	},
/obj/effect/turf_decal/siding/wood,
/obj/machinery/light,
/turf/open/floor/carpet/green,
/area/misc/hilbertshotel)
"eQ" = (
/obj/effect/turf_decal/siding/wood{
	dir = 10
	},
/obj/structure/table,
/obj/effect/spawner/random/food_or_drink/three_course_meal,
/turf/open/floor/iron/cafeteria,
/area/misc/hilbertshotel)
"fl" = (
/obj/structure/flora/grass/jungle/b,
/obj/structure/flora/grass/jungle/b,
/obj/structure/flora/grass/jungle,
/obj/structure/flora/rock/pile/jungle/style_random,
/turf/open/misc/grass/jungle/station,
/area/misc/hilbertshotel)
"fE" = (
/obj/structure/flora/rock/pile,
/obj/structure/flora/grass/jungle/b,
/obj/structure/flora/grass/jungle,
/turf/open/misc/dirt/station,
/area/misc/hilbertshotel)
"fN" = (
/obj/structure/flora/bush/jungle/c/style_random,
/turf/open/water,
/area/misc/hilbertshotel)
"gX" = (
/obj/structure/spacevine,
/obj/structure/flora/grass/jungle,
/obj/structure/flora/grass/jungle/b/style_random,
/obj/structure/flora/rock/pile/jungle/style_random,
/turf/open/misc/grass/jungle/station,
/area/misc/hilbertshotel)
"hg" = (
/obj/effect/turf_decal/siding/wood{
	dir = 5
	},
/obj/structure/bed/double,
/turf/open/floor/carpet/royalblue,
/area/misc/hilbertshotel)
"hR" = (
/obj/structure/table/wood,
/obj/structure/window/reinforced,
/obj/item/paper_bin,
/obj/item/pen/fountain,
/obj/structure/curtain/cloth/fancy,
/turf/open/floor/wood/tile,
/area/misc/hilbertshotel)
"hT" = (
/obj/structure/flora/grass/jungle/b,
/obj/structure/flora/bush/jungle/c/style_random,
/obj/structure/flora/bush/jungle/b/style_random,
/turf/open/misc/grass/jungle/station,
/area/misc/hilbertshotel)
"iw" = (
/obj/machinery/vending/games{
	shut_up = 1;
	onstation = 0
	},
/turf/closed/indestructible/wood,
/area/misc/hilbertshotel)
"iF" = (
/obj/machinery/light/small{
	dir = 8
	},
/obj/structure/railing{
	dir = 8
	},
/obj/structure/railing{
	dir = 8;
	icon_state = "railing"
	},
/turf/open/indestructible/cobble/corner{
	dir = 8
	},
/area/misc/hilbertshotel)
"iL" = (
/obj/structure/flora/bush/jungle/c/style_random,
/turf/open/misc/grass/jungle/station,
/area/misc/hilbertshotel)
"iO" = (
/obj/structure/flora/grass/jungle/b,
/turf/open/misc/dirt/station,
/area/misc/hilbertshotel)
"iS" = (
/obj/structure/mineral_door/paperframe,
/turf/open/floor/wood/tile,
/area/misc/hilbertshotel)
"jh" = (
/obj/structure/flora/tree/jungle/small,
/obj/structure/flora/rock/pile/jungle/style_random,
/turf/open/water,
/area/misc/hilbertshotel)
"jw" = (
/obj/machinery/telecomms/relay/preset/auto,
/turf/open/floor/catwalk_floor,
/area/misc/hilbertshotel)
"kf" = (
/obj/structure/spacevine,
/turf/closed/indestructible/rock,
/area/misc/hilbertshotel)
"kS" = (
/obj/structure/flora/grass/jungle,
/obj/structure/flora/grass/jungle/b/style_random,
/turf/open/water,
/area/misc/hilbertshotel)
"kV" = (
/obj/structure/flora/grass/jungle,
/obj/structure/flora/bush/jungle/c/style_random,
/obj/structure/flora/rock/pile/jungle/style_random,
/turf/open/misc/grass/jungle/station,
/area/misc/hilbertshotel)
"lo" = (
/obj/structure/flora/tree/jungle,
/obj/machinery/light/floor{
	light_power = 20;
	light_range = 5
	},
/turf/open/misc/grass/jungle/station,
/area/misc/hilbertshotel)
"ma" = (
/obj/effect/turf_decal/siding/wood{
	dir = 4
	},
/obj/machinery/vending/boozeomat{
	onstation = 0
	},
/obj/machinery/light{
	dir = 4
	},
/turf/open/floor/iron/cafeteria,
/area/misc/hilbertshotel)
"mL" = (
/obj/structure/fireplace,
/turf/open/floor/wood/tile,
/area/misc/hilbertshotel)
"ng" = (
/obj/structure/flora/grass/jungle,
/turf/open/misc/dirt/station,
/area/misc/hilbertshotel)
"nq" = (
/obj/machinery/light{
	dir = 8
	},
/turf/open/floor/wood/tile,
/area/misc/hilbertshotel)
"od" = (
/obj/machinery/light{
	dir = 8
	},
/obj/structure/flora/grass/jungle/b/style_random,
/turf/open/misc/dirt/station,
/area/misc/hilbertshotel)
"pH" = (
/turf/closed/indestructible/wood,
/area/misc/hilbertshotel)
"qa" = (
/obj/effect/turf_decal/siding/wood,
/obj/structure/chair/wood,
/turf/open/floor/carpet/royalblue,
/area/misc/hilbertshotel)
"qP" = (
/obj/effect/turf_decal/siding/wood{
	dir = 9
	},
/obj/machinery/light_switch/directional/north,
/turf/open/floor/carpet/royalblue,
/area/misc/hilbertshotel)
"rx" = (
/obj/structure/railing{
	dir = 8
	},
/obj/structure/fake_stairs/directional/north,
/turf/open/misc/dirt/station,
/area/misc/hilbertshotel)
"sd" = (
/obj/effect/turf_decal/siding/wood,
/obj/structure/table,
/obj/machinery/reagentgrinder,
/turf/open/floor/iron/cafeteria,
/area/misc/hilbertshotel)
"sx" = (
/obj/structure/flora/bush/jungle/c/style_random,
/obj/structure/flora/rock/pile/jungle/style_random,
/turf/open/water,
/area/misc/hilbertshotel)
"sF" = (
/obj/effect/turf_decal/siding/wood{
	dir = 9
	},
/obj/structure/chair/sofa/corp/left{
	dir = 4
	},
/turf/open/floor/carpet/green,
/area/misc/hilbertshotel)
"sP" = (
/obj/effect/turf_decal/siding/wood{
	dir = 6
	},
/obj/structure/table,
/obj/machinery/microwave,
/turf/open/floor/iron/cafeteria,
/area/misc/hilbertshotel)
"tv" = (
/obj/structure/railing/corner,
/obj/machinery/light/small{
	dir = 1
	},
/turf/open/indestructible/hoteltile,
/area/misc/hilbertshotel)
"tX" = (
/obj/structure/flora/rock/pile/jungle/style_random,
/turf/open/misc/dirt/station,
/area/misc/hilbertshotel)
"uw" = (
/obj/machinery/light,
/turf/open/water,
/area/misc/hilbertshotel)
"vy" = (
/obj/structure/table/wood,
/obj/structure/window/reinforced,
/obj/structure/curtain/cloth/fancy,
/turf/open/floor/wood/tile,
/area/misc/hilbertshotel)
"vK" = (
/obj/machinery/vending/coffee{
	shut_up = 1;
	onstation = 0
	},
/turf/closed/indestructible/wood,
/area/misc/hilbertshotel)
"wQ" = (
/obj/structure/flora/grass/jungle/b,
/obj/structure/chair/pew/right,
/obj/item/instrument/banjo,
/turf/open/misc/grass/jungle/station,
/area/misc/hilbertshotel)
"xx" = (
/obj/structure/chair/sofa/corp/right{
	dir = 1
	},
/obj/effect/turf_decal/siding/wood{
	dir = 6
	},
/turf/open/floor/carpet/green,
/area/misc/hilbertshotel)
"yh" = (
/obj/structure/mineral_door/wood,
/turf/open/floor/wood,
/area/misc/hilbertshotel)
"yr" = (
/turf/closed/indestructible/rock,
/area/misc/hilbertshotel)
"yC" = (
/obj/structure/bonfire,
/turf/open/misc/dirt/station,
/area/misc/hilbertshotel)
"yQ" = (
/obj/structure/chair/pew/left,
/turf/open/misc/grass/jungle/station,
/area/misc/hilbertshotel)
"zn" = (
/obj/effect/turf_decal/siding/wood{
	dir = 8
	},
/obj/structure/table,
/obj/item/sharpener,
/turf/open/floor/iron/cafeteria,
/area/misc/hilbertshotel)
"zJ" = (
/obj/structure/flora/grass/jungle/b/style_random,
/obj/structure/flora/rock/pile/jungle/style_random,
/turf/open/misc/grass/jungle/station,
/area/misc/hilbertshotel)
"zX" = (
/obj/structure/closet/cabinet,
/obj/effect/turf_decal/siding/wood{
	dir = 6
	},
/obj/item/clothing/shoes/sandal,
/obj/item/clothing/shoes/sandal,
/turf/open/floor/carpet/royalblue,
/area/misc/hilbertshotel)
"Ah" = (
/turf/open/floor/wood/tile,
/area/misc/hilbertshotel)
"Ao" = (
/obj/structure/flora/grass/jungle/b/style_random,
/turf/open/misc/grass/jungle/station,
/area/misc/hilbertshotel)
"Aw" = (
/obj/machinery/light/small{
	dir = 1
	},
/obj/machinery/light/floor{
	light_power = 20;
	light_range = 5
	},
/obj/structure/flora/bush/jungle/a/style_random,
/obj/structure/flora/bush/large/style_random,
/turf/open/misc/grass/jungle/station,
/area/misc/hilbertshotel)
"AL" = (
/turf/open/indestructible/cobble/corner{
	dir = 4
	},
/area/misc/hilbertshotel)
"BA" = (
/obj/structure/flora/grass/jungle,
/obj/structure/flora/bush/jungle/c/style_random,
/turf/open/misc/grass/jungle/station,
/area/misc/hilbertshotel)
"CC" = (
/obj/structure/flora/grass/jungle/b/style_random,
/obj/structure/flora/bush/jungle/c/style_random,
/turf/open/misc/grass/jungle/station,
/area/misc/hilbertshotel)
"CR" = (
/obj/structure/flora/grass/jungle/b,
/obj/structure/flora/rock/pile/jungle/style_random,
/turf/open/water,
/area/misc/hilbertshotel)
"Dl" = (
/turf/closed/indestructible/hoteldoor{
	icon_state = "door_closed";
	icon = 'icons/obj/doors/puzzledoor/default.dmi'
	},
/area/misc/hilbertshotel)
"Eh" = (
/obj/effect/turf_decal/siding/wood{
	dir = 1
	},
/turf/open/floor/carpet/royalblue,
/area/misc/hilbertshotel)
"Es" = (
/obj/effect/turf_decal/siding/wood{
	dir = 5
	},
/turf/open/floor/carpet/green,
/area/misc/hilbertshotel)
"Ex" = (
/obj/structure/flora/grass/jungle,
/turf/open/misc/grass/jungle/station,
/area/misc/hilbertshotel)
"Fg" = (
/obj/structure/closet/crate/wooden,
/obj/item/stack/sheet/mineral/wood/fifty,
/obj/machinery/light,
/obj/item/towel,
/turf/open/floor/wood,
/area/misc/hilbertshotel)
"Ft" = (
/obj/machinery/light_switch/directional/north,
/turf/open/floor/wood/tile,
/area/misc/hilbertshotel)
"Fu" = (
/obj/structure/flora/tree/jungle,
/obj/structure/spacevine,
/turf/closed/indestructible/rock,
/area/misc/hilbertshotel)
"Gr" = (
/obj/effect/turf_decal/siding/wood{
	dir = 9
	},
/turf/open/floor/iron/cafeteria,
/area/misc/hilbertshotel)
"GS" = (
/obj/structure/flora/rock/pile,
/obj/structure/flora/bush/jungle/c/style_random,
/obj/structure/flora/bush/jungle/a/style_random,
/turf/open/misc/dirt/station,
/area/misc/hilbertshotel)
"Hz" = (
/obj/structure/chair/stool/bar,
/turf/open/floor/wood/tile,
/area/misc/hilbertshotel)
"HK" = (
/obj/structure/flora/grass/jungle,
/turf/open/water,
/area/misc/hilbertshotel)
"HM" = (
/turf/open/floor/iron/pool,
/area/misc/hilbertshotel)
"HX" = (
/obj/structure/table/glass,
/obj/effect/turf_decal/siding/wood{
	dir = 1
	},
/obj/item/storage/fancy/heart_box,
/turf/open/floor/carpet/green,
/area/misc/hilbertshotel)
"Ii" = (
/obj/structure/fake_stairs/directional/north,
/turf/open/misc/dirt/station,
/area/misc/hilbertshotel)
"IP" = (
/obj/effect/turf_decal/siding/wood{
	dir = 1
	},
/obj/structure/sink/kitchen{
	pixel_y = 20
	},
/turf/open/floor/iron/cafeteria,
/area/misc/hilbertshotel)
"JE" = (
/obj/machinery/light/floor{
	light_power = 20;
	light_range = 5
	},
/obj/structure/flora/grass/jungle/b/style_random,
/obj/structure/flora/bush/jungle/c/style_random,
/obj/structure/flora/rock/pile/jungle/style_random,
/turf/open/misc/dirt/station,
/area/misc/hilbertshotel)
"JM" = (
/obj/structure/window/reinforced,
/turf/open/floor/iron/pool,
/area/misc/hilbertshotel)
"KO" = (
/obj/structure/flora/grass/jungle,
/obj/structure/spacevine,
/obj/structure/flora/grass/jungle/b/style_random,
/obj/structure/flora/bush/jungle/a/style_random,
/turf/open/misc/grass/jungle/station,
/area/misc/hilbertshotel)
"Ld" = (
/obj/structure/flora/grass/jungle/b,
/obj/structure/flora/grass/jungle,
/obj/structure/flora/bush/jungle/c/style_random,
/turf/open/misc/grass/jungle/station,
/area/misc/hilbertshotel)
"LZ" = (
/turf/open/misc/grass/jungle/station,
/area/misc/hilbertshotel)
"Ml" = (
/obj/structure/spacevine,
/turf/open/misc/grass/jungle/station,
/area/misc/hilbertshotel)
"MQ" = (
/obj/structure/flora/grass/jungle/b/style_random,
/obj/structure/flora/bush/jungle/a/style_random,
/turf/open/misc/grass/jungle/station,
/area/misc/hilbertshotel)
"Nz" = (
/obj/machinery/light/floor{
	light_power = 20;
	light_range = 5
	},
/turf/open/water,
/area/misc/hilbertshotel)
"NJ" = (
/obj/structure/flora/grass/jungle,
/obj/structure/flora/tree/jungle/small,
/obj/structure/flora/bush/jungle/b/style_random,
/turf/open/misc/grass/jungle/station,
/area/misc/hilbertshotel)
"NT" = (
/obj/structure/flora/grass/jungle,
/obj/structure/flora/grass/jungle/b,
/turf/open/misc/grass/jungle/station,
/area/misc/hilbertshotel)
"Op" = (
/obj/structure/flora/grass/jungle/b/style_random,
/obj/structure/flora/bush/jungle/b/style_random,
/turf/open/misc/grass/jungle/station,
/area/misc/hilbertshotel)
"Oq" = (
/obj/structure/flora/grass/jungle,
/obj/machinery/light/small{
	dir = 1
	},
/obj/structure/flora/bush/jungle/c/style_random,
/turf/open/misc/grass/jungle/station,
/area/misc/hilbertshotel)
"Oy" = (
/obj/effect/turf_decal/siding/wood{
	dir = 5
	},
/obj/machinery/vending/dinnerware{
	contraband = list(/obj/item/kitchen/rollingpin=2,/obj/item/kitchen/knife/butcher=2,/obj/item/reagent_containers/food/condiment/flour=4);
	shut_up = 1;
	onstation = 0
	},
/turf/open/floor/iron/cafeteria,
/area/misc/hilbertshotel)
"OG" = (
/obj/structure/table/wood,
/obj/item/flashlight/lamp/green,
/obj/structure/window/reinforced,
/obj/structure/curtain/cloth/fancy,
/turf/open/floor/wood/tile,
/area/misc/hilbertshotel)
"Po" = (
/obj/structure/flora/tree/jungle/small,
/turf/open/water,
/area/misc/hilbertshotel)
"Pq" = (
/obj/structure/sink/directional/east,
/obj/structure/mirror/directional/west,
/turf/open/indestructible/hoteltile,
/area/misc/hilbertshotel)
"Px" = (
/obj/structure/flora/tree/jungle/small,
/obj/structure/spacevine,
/turf/closed/indestructible/rock,
/area/misc/hilbertshotel)
"Qd" = (
/obj/machinery/light{
	dir = 1
	},
/turf/open/floor/wood/tile,
/area/misc/hilbertshotel)
"Qs" = (
/obj/machinery/shower/directional/west,
/turf/open/floor/iron/pool,
/area/misc/hilbertshotel)
"QO" = (
/obj/structure/flora/grass/jungle/b,
/turf/open/water,
/area/misc/hilbertshotel)
"QY" = (
/obj/structure/flora/grass/jungle/b/style_random,
/obj/structure/flora/bush/jungle/c/style_random,
/obj/structure/flora/bush/jungle/a/style_random,
/turf/open/misc/dirt/station,
/area/misc/hilbertshotel)
"RF" = (
/obj/structure/railing,
/turf/open/indestructible/hoteltile,
/area/misc/hilbertshotel)
"RZ" = (
/obj/structure/spacevine,
/obj/structure/flora/tree/jungle/small,
/turf/closed/indestructible/rock,
/area/misc/hilbertshotel)
"Sj" = (
/obj/structure/window/reinforced{
	dir = 8
	},
/obj/machinery/jukebox{
	req_one_access = null;
	set_obj_flags = "EMAGGED"
	},
/turf/open/floor/wood,
/area/misc/hilbertshotel)
"Sm" = (
/obj/machinery/light{
	dir = 8
	},
/obj/structure/flora/bush/jungle/b/style_random,
/obj/structure/flora/bush/jungle/a/style_random,
/turf/open/misc/grass/jungle/station,
/area/misc/hilbertshotel)
"Vt" = (
/turf/open/water,
/area/misc/hilbertshotel)
"VY" = (
/turf/open/floor/iron/cafeteria,
/area/misc/hilbertshotel)
"Wg" = (
/obj/structure/flora/grass/jungle/b/style_random,
/obj/structure/flora/rock/pile/jungle/style_random,
/turf/open/misc/dirt/station,
/area/misc/hilbertshotel)
"Wh" = (
/obj/structure/toilet{
	dir = 4
	},
/obj/item/soap,
/obj/structure/window/reinforced/tinted{
	dir = 4
	},
/turf/open/indestructible/hoteltile,
/area/misc/hilbertshotel)
"WJ" = (
/turf/open/misc/dirt/station,
/area/misc/hilbertshotel)
"Xh" = (
/obj/structure/flora/bush/jungle/c/style_random,
/obj/structure/flora/bush/jungle/b/style_random,
/turf/open/misc/grass/jungle/station,
/area/misc/hilbertshotel)
"Xm" = (
/obj/structure/flora/grass/jungle/b/style_random,
/turf/open/misc/dirt/station,
/area/misc/hilbertshotel)
"YF" = (
/obj/structure/flora/rock/pile/jungle/style_random,
/turf/open/water,
/area/misc/hilbertshotel)
"Za" = (
/obj/structure/flora/bush/jungle/c/style_random,
/turf/open/misc/dirt/station,
/area/misc/hilbertshotel)
"ZM" = (
/obj/effect/turf_decal/siding/wood{
	dir = 10
	},
/obj/structure/closet/crate/bin{
	pixel_x = -6
	},
/turf/open/floor/carpet/royalblue,
/area/misc/hilbertshotel)

(1,1,1) = {"
yr
yr
yr
kf
kf
kf
kf
kf
Px
Dl
kf
kf
Px
kf
kf
RZ
"}
(2,1,1) = {"
yr
MQ
KO
gX
fl
NT
NJ
Sm
ng
WJ
Ao
Op
od
Vt
Px
kf
"}
(3,1,1) = {"
kf
Ml
Ml
Ml
lo
fE
iO
WJ
iO
WJ
CC
zJ
Wg
fN
Vt
Fu
"}
(4,1,1) = {"
kf
bU
iF
rx
rx
rx
ng
WJ
WJ
aV
Ex
cC
tX
Vt
uw
kf
"}
(5,1,1) = {"
kf
cA
AL
Ii
Ii
Ii
WJ
iO
aV
hT
Xh
GS
Vt
CR
Vt
Px
"}
(6,1,1) = {"
pH
yh
pH
Sj
pH
pH
pH
pH
Aw
Ld
kV
Za
HK
YF
Vt
kf
"}
(7,1,1) = {"
pH
Ft
nq
Ah
pH
Pq
Wh
pH
yQ
LZ
bn
Xm
Vt
YF
jh
kf
"}
(8,1,1) = {"
iw
Ah
sF
bt
pH
tv
HM
JM
cp
LZ
yC
Xm
HK
YF
YF
Fu
"}
(9,1,1) = {"
pH
mL
HX
dQ
pH
RF
Qs
JM
cp
BA
Xm
kS
YF
YF
Vt
kf
"}
(10,1,1) = {"
vK
Ah
Es
xx
pH
iS
pH
pH
wQ
LZ
Za
Vt
CR
YF
Vt
Px
"}
(11,1,1) = {"
pH
Qd
dl
dl
dl
dl
Fg
pH
Oq
bn
Wg
sx
Vt
Vt
Vt
kf
"}
(12,1,1) = {"
pH
Ah
Hz
Hz
pH
iS
pH
pH
hT
QY
WJ
YF
Vt
Nz
Vt
Fu
"}
(13,1,1) = {"
pH
Gr
zn
eQ
pH
qP
ZM
OG
iL
JE
Vt
fN
Vt
Po
Vt
kf
"}
(14,1,1) = {"
pH
IP
VY
sd
pH
Eh
qa
hR
Ex
tX
HK
QO
Vt
Vt
Vt
Fu
"}
(15,1,1) = {"
pH
Oy
ma
sP
pH
hg
zX
vy
Ao
Wg
YF
cg
Vt
Vt
Px
kf
"}
(16,1,1) = {"
pH
pH
pH
pH
pH
pH
pH
pH
kf
kf
Fu
kf
kf
Fu
kf
jw
"}
