//MAP CONVERTED BY dmm2tgm.py THIS HEADER COMMENT PREVENTS RECONVERSION, DO NOT REMOVE
"ag" = (
/obj/effect/turf_decal/siding/wood/corner{
	dir = 4
	},
/obj/effect/turf_decal/siding/wood/corner,
/turf/open/floor/carpet,
/area/misc/hilbertshotel)
"aO" = (
/obj/effect/turf_decal/siding/wood{
	dir = 8
	},
/turf/open/floor/wood/tile,
/area/misc/hilbertshotel)
"aP" = (
/obj/effect/turf_decal/siding/wood{
	dir = 5
	},
/obj/structure/table/wood,
/obj/item/flashlight/lamp/green{
	pixel_x = 5;
	pixel_y = 14
	},
/obj/item/choice_beacon/box/plushie,
/turf/open/floor/carpet/royalblue,
/area/misc/hilbertshotel)
"br" = (
/obj/effect/turf_decal/siding/wood{
	dir = 4
	},
/obj/machinery/light/small{
	dir = 4;
	pixel_y = 17
	},
/turf/open/floor/wood/tile,
/area/misc/hilbertshotel)
"bH" = (
/obj/effect/turf_decal/siding/wood{
	dir = 6
	},
/obj/structure/closet/crate/wooden,
/obj/item/stack/sheet/mineral/wood/fifty,
/turf/open/floor/wood/tile,
/area/misc/hilbertshotel)
"cC" = (
/obj/structure/chair/pew/right{
	dir = 4
	},
/obj/effect/turf_decal/siding/wood{
	dir = 8
	},
/turf/open/floor/wood/tile,
/area/misc/hilbertshotel)
"cI" = (
/obj/effect/turf_decal/siding/wood{
	dir = 5
	},
/obj/structure/table/wood,
/obj/item/shovel,
/obj/machinery/light/floor{
	light_color = "#f27d0c";
	color = "FFB43A"
	},
/obj/item/wrench{
	pixel_x = 6
	},
/obj/item/flashlight/lantern{
	icon_state = "lantern-on";
	pixel_x = -8;
	pixel_y = 13
	},
/turf/open/floor/wood/tile,
/area/misc/hilbertshotel)
"cN" = (
/obj/structure/table/reinforced,
/obj/machinery/microwave{
	pixel_y = 6
	},
/turf/open/floor/iron/cafeteria,
/area/misc/hilbertshotel)
"dl" = (
/obj/effect/turf_decal/siding/wood,
/turf/open/floor/wood/tile,
/area/misc/hilbertshotel)
"dz" = (
/obj/structure/window/reinforced,
/obj/structure/table/wood,
/obj/item/storage/fancy/heart_box,
/obj/structure/curtain/cloth/fancy,
/turf/open/floor/wood/tile,
/area/misc/hilbertshotel)
"eC" = (
/obj/machinery/vending/boozeomat{
	onstation = 0
	},
/turf/closed/indestructible/wood,
/area/misc/hilbertshotel)
"eS" = (
/obj/effect/turf_decal/siding/wood{
	dir = 5
	},
/obj/machinery/jukebox{
	req_one_access = null;
	area_limited = 1
	},
/turf/open/floor/wood/tile,
/area/misc/hilbertshotel)
"fN" = (
/obj/structure/flora/grass/green,
/turf/open/floor/fake_snow/safe,
/area/misc/hilbertshotel)
"gq" = (
/obj/structure/chair/wood{
	dir = 1
	},
/turf/open/floor/fake_snow/safe,
/area/misc/hilbertshotel)
"gB" = (
/obj/machinery/vending/games{
	shut_up = 1;
	onstation = 0
	},
/turf/closed/indestructible/wood,
/area/misc/hilbertshotel)
"gX" = (
/obj/structure/bookcase/random/fiction,
/turf/closed/indestructible/wood,
/area/misc/hilbertshotel)
"hA" = (
/obj/effect/turf_decal/siding/wood{
	dir = 8
	},
/obj/effect/turf_decal/siding/wood/corner,
/turf/open/floor/wood/tile,
/area/misc/hilbertshotel)
"hD" = (
/obj/effect/turf_decal/siding/wood,
/obj/effect/turf_decal/siding/wood{
	dir = 1
	},
/obj/structure/mineral_door/wood,
/turf/open/floor/wood/tile,
/area/misc/hilbertshotel)
"iB" = (
/obj/effect/turf_decal/siding/wood/corner{
	dir = 1
	},
/obj/effect/turf_decal/siding/wood/corner{
	dir = 8
	},
/turf/open/floor/wood/tile,
/area/misc/hilbertshotel)
"iJ" = (
/obj/structure/fans/tiny/invisible,
/obj/effect/turf_decal/siding/wood/end{
	dir = 1
	},
/obj/structure/mineral_door/wood,
/turf/open/floor/wood/tile,
/area/misc/hilbertshotel)
"jw" = (
/obj/machinery/telecomms/relay/preset/auto,
/turf/open/floor/catwalk_floor,
/area/misc/hilbertshotel)
"kf" = (
/obj/structure/table/reinforced,
/obj/effect/spawner/random/food_or_drink/three_course_meal,
/turf/open/floor/iron/cafeteria,
/area/misc/hilbertshotel)
"kS" = (
/obj/effect/turf_decal/siding/wood{
	dir = 8
	},
/obj/structure/closet/cabinet{
	pixel_x = -6
	},
/turf/open/floor/wood/tile,
/area/misc/hilbertshotel)
"kY" = (
/obj/structure/flora/grass/green,
/obj/machinery/light/small{
	dir = 1
	},
/turf/open/floor/fake_snow/safe,
/area/misc/hilbertshotel)
"lh" = (
/obj/effect/turf_decal/siding/wood{
	dir = 8
	},
/obj/structure/chair/sofa/middle/brown{
	dir = 4
	},
/turf/open/floor/carpet/royalblack,
/area/misc/hilbertshotel)
"lj" = (
/obj/effect/turf_decal/siding/wood,
/obj/structure/chair/sofa/right/brown{
	dir = 1
	},
/turf/open/floor/carpet/royalblack,
/area/misc/hilbertshotel)
"lp" = (
/obj/effect/turf_decal/siding/wood{
	dir = 6
	},
/obj/structure/bed/double,
/turf/open/floor/carpet/royalblue,
/area/misc/hilbertshotel)
"lC" = (
/obj/structure/closet/crate/freezer,
/obj/effect/turf_decal/siding/wood{
	dir = 6
	},
/obj/item/reagent_containers/cup/glass/bottle/beer,
/obj/item/reagent_containers/cup/glass/bottle/beer{
	pixel_y = 12
	},
/obj/item/reagent_containers/cup/glass/bottle/beer{
	pixel_y = 12;
	pixel_x = 9
	},
/obj/item/reagent_containers/cup/glass/bottle/beer{
	pixel_y = 9
	},
/obj/item/reagent_containers/cup/glass/bottle/beer{
	pixel_y = 9;
	pixel_x = -9
	},
/obj/item/storage/cans/sixbeer,
/turf/open/floor/wood/tile,
/area/misc/hilbertshotel)
"lT" = (
/obj/structure/window/reinforced,
/obj/structure/table/wood,
/obj/effect/spawner/random/entertainment/lighter,
/obj/structure/curtain/cloth/fancy,
/turf/open/floor/wood/tile,
/area/misc/hilbertshotel)
"mp" = (
/obj/effect/turf_decal/siding/wood{
	dir = 10
	},
/obj/machinery/vending/dorms,
/turf/open/floor/carpet,
/area/misc/hilbertshotel)
"mz" = (
/obj/effect/turf_decal/siding/wood,
/turf/open/floor/carpet/royalblue,
/area/misc/hilbertshotel)
"nb" = (
/obj/structure/flora/tree/pine,
/turf/open/floor/fake_snow/safe,
/area/misc/hilbertshotel)
"nk" = (
/obj/effect/turf_decal/siding/wood{
	dir = 1
	},
/obj/machinery/light_switch/directional/north,
/turf/open/floor/wood/tile,
/area/misc/hilbertshotel)
"nH" = (
/obj/structure/fans/tiny/invisible,
/obj/effect/turf_decal/siding/wood/end{
	dir = 4
	},
/obj/structure/mineral_door/wood,
/turf/open/floor/wood/tile,
/area/misc/hilbertshotel)
"nY" = (
/obj/structure/chair/pew/left{
	dir = 4
	},
/obj/effect/turf_decal/siding/wood{
	dir = 8
	},
/turf/open/floor/wood/tile,
/area/misc/hilbertshotel)
"oF" = (
/obj/effect/turf_decal/siding/wood{
	dir = 6
	},
/obj/structure/closet/cabinet,
/obj/item/clothing/shoes/winterboots{
	pixel_x = 2;
	pixel_y = -2
	},
/obj/item/clothing/shoes/winterboots{
	pixel_x = 2;
	pixel_y = -2
	},
/obj/item/clothing/suit/hooded/wintercoat,
/obj/item/clothing/suit/hooded/wintercoat,
/turf/open/floor/wood/tile,
/area/misc/hilbertshotel)
"pd" = (
/obj/structure/chair/wood{
	dir = 8
	},
/turf/open/floor/fake_snow/safe,
/area/misc/hilbertshotel)
"pH" = (
/obj/effect/turf_decal/siding/wood{
	dir = 6
	},
/turf/open/floor/carpet/royalblack,
/area/misc/hilbertshotel)
"pM" = (
/obj/effect/turf_decal/siding/wood{
	dir = 1
	},
/turf/open/floor/wood/tile,
/area/misc/hilbertshotel)
"pO" = (
/obj/effect/turf_decal/siding/wood{
	dir = 9
	},
/obj/machinery/computer{
	dir = 4;
	pixel_x = -3
	},
/turf/open/floor/carpet/royalblue,
/area/misc/hilbertshotel)
"pR" = (
/obj/structure/chair/pew,
/obj/effect/turf_decal/siding/wood{
	dir = 1
	},
/obj/machinery/light{
	dir = 1
	},
/turf/open/floor/wood/tile,
/area/misc/hilbertshotel)
"rA" = (
/obj/effect/turf_decal/siding/wood{
	dir = 5
	},
/turf/open/floor/carpet,
/area/misc/hilbertshotel)
"rE" = (
/obj/effect/turf_decal/siding/wood{
	dir = 10
	},
/obj/structure/closet/cabinet,
/obj/item/clothing/shoes/sandal,
/obj/item/clothing/shoes/sandal,
/obj/item/clothing/under/costume/skyrat/bathrobe,
/turf/open/floor/carpet/royalblue,
/area/misc/hilbertshotel)
"sx" = (
/obj/structure/flora/grass/both,
/turf/open/floor/fake_snow/safe,
/area/misc/hilbertshotel)
"sS" = (
/obj/structure/chair/pew/right,
/turf/open/floor/fake_snow/safe,
/area/misc/hilbertshotel)
"tg" = (
/obj/structure/mirror{
	pixel_x = 32
	},
/obj/structure/sink/directional/west,
/turf/open/indestructible/hoteltile,
/area/misc/hilbertshotel)
"tX" = (
/obj/effect/turf_decal/siding/wood{
	dir = 4
	},
/obj/machinery/light_switch/directional/east,
/turf/open/floor/wood/tile,
/area/misc/hilbertshotel)
"uz" = (
/obj/structure/sink/kitchen/directional/east,
/turf/open/floor/iron/cafeteria,
/area/misc/hilbertshotel)
"uD" = (
/obj/effect/turf_decal/siding/wood/corner,
/obj/effect/turf_decal/siding/wood/corner{
	dir = 8
	},
/turf/open/floor/carpet/royalblue,
/area/misc/hilbertshotel)
"vx" = (
/obj/effect/turf_decal/siding/wood{
	dir = 1
	},
/obj/structure/chair/sofa/left/brown,
/turf/open/floor/carpet/royalblack,
/area/misc/hilbertshotel)
"we" = (
/obj/structure/chair/wood,
/turf/open/floor/fake_snow/safe,
/area/misc/hilbertshotel)
"xr" = (
/obj/structure/sauna_oven,
/obj/effect/turf_decal/siding/wood{
	dir = 10
	},
/turf/open/floor/wood/tile,
/area/misc/hilbertshotel)
"xv" = (
/turf/open/floor/fake_snow/safe,
/area/misc/hilbertshotel)
"xJ" = (
/obj/effect/turf_decal/siding/wood{
	dir = 4
	},
/turf/open/floor/carpet/royalblack,
/area/misc/hilbertshotel)
"xQ" = (
/obj/effect/turf_decal/siding/wood{
	dir = 1
	},
/obj/machinery/light{
	dir = 1
	},
/obj/structure/sign/poster/official/the_owl{
	pixel_y = 32
	},
/turf/open/floor/wood/tile,
/area/misc/hilbertshotel)
"yr" = (
/obj/structure/flora/tree/pine,
/turf/closed/indestructible/rock/snow,
/area/misc/hilbertshotel)
"ys" = (
/obj/machinery/vending/coffee{
	shut_up = 1;
	onstation = 0
	},
/turf/closed/indestructible/wood,
/area/misc/hilbertshotel)
"yU" = (
/turf/open/floor/plating/snowed/smoothed{
	initial_gas_mix = "o2=21.78;n2=82.36;TEMP=275"
	},
/area/misc/hilbertshotel)
"yV" = (
/turf/open/floor/iron/cafeteria,
/area/misc/hilbertshotel)
"Ah" = (
/obj/effect/turf_decal/siding/wood{
	dir = 9
	},
/turf/open/floor/wood/tile,
/area/misc/hilbertshotel)
"As" = (
/obj/effect/turf_decal/siding/wood{
	dir = 10
	},
/obj/structure/closet/cabinet,
/obj/item/clothing/shoes/winterboots{
	pixel_x = 2;
	pixel_y = -2
	},
/obj/item/clothing/shoes/winterboots{
	pixel_x = 2;
	pixel_y = -2
	},
/obj/item/clothing/suit/hooded/wintercoat,
/obj/item/clothing/suit/hooded/wintercoat,
/turf/open/floor/wood/tile,
/area/misc/hilbertshotel)
"BZ" = (
/turf/closed/indestructible/wood,
/area/misc/hilbertshotel)
"CC" = (
/obj/effect/turf_decal/siding/wood{
	dir = 8
	},
/obj/machinery/light/small{
	brightness = 3;
	dir = 8
	},
/turf/open/floor/carpet,
/area/misc/hilbertshotel)
"Dc" = (
/obj/effect/turf_decal/siding/wood{
	dir = 4
	},
/obj/structure/fireplace{
	dir = 8
	},
/turf/open/floor/wood/tile,
/area/misc/hilbertshotel)
"De" = (
/obj/machinery/light/small{
	dir = 1
	},
/turf/open/floor/fake_snow/safe,
/area/misc/hilbertshotel)
"Dl" = (
/turf/closed/indestructible/hoteldoor{
	icon_state = "door_closed";
	icon = 'icons/obj/doors/puzzledoor/default.dmi'
	},
/area/misc/hilbertshotel)
"Dx" = (
/turf/closed/indestructible/rock/snow,
/area/misc/hilbertshotel)
"DA" = (
/obj/structure/bonfire,
/obj/effect/spawner/random/entertainment/lighter,
/turf/open/floor/fake_snow/safe,
/area/misc/hilbertshotel)
"Eg" = (
/obj/effect/turf_decal/siding/wood/corner{
	dir = 4
	},
/obj/effect/turf_decal/siding/wood/corner,
/turf/open/floor/wood/tile,
/area/misc/hilbertshotel)
"Ew" = (
/obj/structure/chair/pew/left,
/turf/open/floor/fake_snow/safe,
/area/misc/hilbertshotel)
"Ex" = (
/obj/structure/table/wood,
/obj/effect/turf_decal/siding/wood{
	dir = 6
	},
/obj/structure/towel_bin,
/turf/open/floor/wood/tile,
/area/misc/hilbertshotel)
"Fs" = (
/obj/structure/flora/tree/dead,
/turf/closed/indestructible/rock/snow,
/area/misc/hilbertshotel)
"Fu" = (
/obj/effect/turf_decal/siding/wood{
	dir = 8
	},
/obj/effect/turf_decal/siding/wood/corner{
	dir = 4
	},
/turf/open/floor/wood/tile,
/area/misc/hilbertshotel)
"GU" = (
/obj/effect/turf_decal/siding/wood{
	dir = 5
	},
/turf/open/floor/carpet/royalblack,
/area/misc/hilbertshotel)
"Hw" = (
/obj/structure/fans/tiny/invisible,
/obj/effect/turf_decal/siding/wood,
/obj/effect/turf_decal/siding/wood{
	dir = 1
	},
/obj/structure/mineral_door/wood,
/turf/open/floor/wood/tile,
/area/misc/hilbertshotel)
"HM" = (
/obj/structure/chair/pew/left,
/obj/effect/turf_decal/siding/wood{
	dir = 1
	},
/turf/open/floor/wood/tile,
/area/misc/hilbertshotel)
"HN" = (
/obj/effect/turf_decal/siding/wood{
	dir = 8
	},
/obj/effect/turf_decal/siding/wood{
	dir = 4
	},
/obj/structure/mineral_door/wood,
/turf/open/floor/wood/tile,
/area/misc/hilbertshotel)
"Iy" = (
/obj/effect/turf_decal/siding/wood{
	dir = 1
	},
/obj/structure/chair/office{
	dir = 8;
	pixel_x = -9
	},
/turf/open/floor/carpet/royalblue,
/area/misc/hilbertshotel)
"JC" = (
/obj/structure/table/wood/fancy,
/obj/item/flashlight/flare/candle/infinite,
/turf/open/floor/carpet/royalblack,
/area/misc/hilbertshotel)
"JY" = (
/obj/effect/turf_decal/siding/wood{
	dir = 9
	},
/obj/structure/closet/cabinet{
	pixel_x = -6
	},
/turf/open/floor/wood/tile,
/area/misc/hilbertshotel)
"LH" = (
/obj/effect/turf_decal/siding/wood{
	dir = 10
	},
/obj/structure/chair/sofa/corner/brown{
	dir = 1
	},
/turf/open/floor/carpet/royalblack,
/area/misc/hilbertshotel)
"Mt" = (
/obj/effect/turf_decal/siding/wood/corner{
	dir = 1
	},
/turf/open/floor/wood/tile,
/area/misc/hilbertshotel)
"MC" = (
/obj/effect/turf_decal/siding/wood/corner{
	dir = 8
	},
/obj/effect/turf_decal/siding/wood/corner,
/turf/open/floor/carpet/royalblue,
/area/misc/hilbertshotel)
"Ng" = (
/obj/structure/table/reinforced,
/obj/machinery/reagentgrinder{
	pixel_y = 8
	},
/turf/open/floor/iron/cafeteria,
/area/misc/hilbertshotel)
"Nj" = (
/obj/machinery/vending/dinnerware{
	contraband = list(/obj/item/kitchen/rollingpin=2,/obj/item/kitchen/knife/butcher=2,/obj/item/reagent_containers/food/condiment/flour=4);
	shut_up = 1;
	onstation = 0
	},
/turf/closed/indestructible/wood,
/area/misc/hilbertshotel)
"Nl" = (
/obj/structure/reagent_dispensers/watertank,
/obj/effect/turf_decal/siding/wood{
	dir = 9
	},
/turf/open/floor/wood/tile,
/area/misc/hilbertshotel)
"Og" = (
/obj/structure/flora/grass/brown,
/turf/open/floor/fake_snow/safe,
/area/misc/hilbertshotel)
"Oh" = (
/obj/structure/table/reinforced,
/obj/item/sharpener{
	pixel_x = -5
	},
/obj/item/reagent_containers/condiment/peppermill{
	pixel_y = 6;
	pixel_x = 8
	},
/obj/item/reagent_containers/condiment/saltshaker{
	pixel_x = 6
	},
/turf/open/floor/iron/cafeteria,
/area/misc/hilbertshotel)
"Pm" = (
/obj/effect/turf_decal/siding/wood/corner{
	dir = 8
	},
/obj/effect/turf_decal/siding/wood/corner{
	dir = 1
	},
/turf/open/floor/wood/tile,
/area/misc/hilbertshotel)
"Po" = (
/obj/effect/turf_decal/siding/wood,
/obj/machinery/light,
/turf/open/floor/wood/tile,
/area/misc/hilbertshotel)
"Px" = (
/obj/effect/turf_decal/siding/wood{
	dir = 9
	},
/obj/structure/chair/sofa/corner/brown{
	dir = 4
	},
/turf/open/floor/carpet/royalblack,
/area/misc/hilbertshotel)
"PZ" = (
/obj/structure/flora/grass/brown,
/obj/machinery/light/small{
	brightness = 3;
	dir = 8
	},
/obj/machinery/light/small,
/turf/open/floor/fake_snow/safe,
/area/misc/hilbertshotel)
"Qp" = (
/obj/structure/table/wood,
/obj/effect/turf_decal/siding/wood{
	dir = 5
	},
/turf/open/floor/wood/tile,
/area/misc/hilbertshotel)
"Qt" = (
/obj/effect/turf_decal/siding/wood{
	dir = 9
	},
/obj/structure/table/wood,
/obj/structure/reagent_dispensers/beerkeg,
/turf/open/floor/carpet,
/area/misc/hilbertshotel)
"QO" = (
/obj/structure/chair/wood{
	dir = 4
	},
/turf/open/floor/fake_snow/safe,
/area/misc/hilbertshotel)
"QR" = (
/obj/effect/turf_decal/siding/wood{
	dir = 1
	},
/obj/structure/dresser,
/turf/open/floor/carpet/royalblue,
/area/misc/hilbertshotel)
"RQ" = (
/obj/structure/bookcase/random/nonfiction,
/turf/closed/indestructible/wood,
/area/misc/hilbertshotel)
"RW" = (
/obj/structure/chair/pew/right,
/obj/effect/turf_decal/siding/wood{
	dir = 1
	},
/turf/open/floor/wood/tile,
/area/misc/hilbertshotel)
"Su" = (
/obj/structure/closet/crate/wooden,
/obj/item/stack/sheet/mineral/wood/fifty,
/obj/effect/turf_decal/siding/wood{
	dir = 4
	},
/obj/item/reagent_containers/cup/bucket/wooden,
/turf/open/floor/wood/tile,
/area/misc/hilbertshotel)
"Sy" = (
/obj/structure/flora/grass/green,
/obj/machinery/light/small,
/turf/open/floor/fake_snow/safe,
/area/misc/hilbertshotel)
"Tp" = (
/obj/effect/turf_decal/siding/wood{
	dir = 1
	},
/obj/item/kirbyplants/random,
/turf/open/floor/carpet/royalblue,
/area/misc/hilbertshotel)
"TO" = (
/obj/structure/toilet{
	dir = 4
	},
/turf/open/indestructible/hoteltile,
/area/misc/hilbertshotel)
"TX" = (
/obj/structure/chair/pew,
/obj/machinery/light/floor{
	light_color = "#f27d0c";
	color = "FFB43A"
	},
/turf/open/floor/fake_snow/safe,
/area/misc/hilbertshotel)
"Uq" = (
/obj/structure/mineral_door/paperframe,
/turf/open/indestructible/hoteltile,
/area/misc/hilbertshotel)
"Ur" = (
/obj/structure/window/reinforced/tinted,
/obj/item/soap/deluxe,
/obj/machinery/shower/directional/east,
/turf/open/indestructible/hoteltile,
/area/misc/hilbertshotel)
"Vt" = (
/turf/open/floor/wood/large,
/area/misc/hilbertshotel)
"We" = (
/obj/effect/turf_decal/siding/wood/corner,
/obj/effect/turf_decal/siding/wood/corner{
	dir = 4
	},
/turf/open/floor/wood/tile,
/area/misc/hilbertshotel)
"Wx" = (
/obj/effect/turf_decal/siding/wood{
	dir = 4
	},
/obj/effect/turf_decal/siding/wood/corner{
	dir = 1
	},
/turf/open/floor/wood/tile,
/area/misc/hilbertshotel)
"WD" = (
/obj/machinery/light/small{
	dir = 4
	},
/turf/open/indestructible/hoteltile,
/area/misc/hilbertshotel)
"WR" = (
/obj/structure/window/reinforced,
/obj/structure/table/wood,
/obj/item/flashlight/lamp/green,
/obj/structure/curtain/cloth/fancy,
/turf/open/floor/wood/tile,
/area/misc/hilbertshotel)
"WS" = (
/obj/structure/flora/grass/both,
/obj/machinery/light/small{
	brightness = 3;
	dir = 8
	},
/turf/open/floor/fake_snow/safe,
/area/misc/hilbertshotel)
"XA" = (
/obj/structure/closet/crate/bin{
	pixel_x = -6
	},
/obj/machinery/light{
	dir = 8
	},
/turf/open/floor/iron/cafeteria,
/area/misc/hilbertshotel)
"Yd" = (
/obj/structure/bookcase/random/reference,
/turf/closed/indestructible/wood,
/area/misc/hilbertshotel)
"YC" = (
/obj/effect/turf_decal/siding/wood{
	dir = 6
	},
/obj/machinery/vending/cigarette{
	shut_up = 1;
	onstation = 0
	},
/turf/open/floor/carpet,
/area/misc/hilbertshotel)
"YF" = (
/obj/effect/turf_decal/siding/wood{
	dir = 4
	},
/obj/machinery/light/small{
	dir = 4
	},
/obj/machinery/light_switch/directional/east,
/turf/open/floor/wood/tile,
/area/misc/hilbertshotel)
"YH" = (
/obj/effect/turf_decal/siding/wood{
	dir = 4
	},
/obj/machinery/light{
	dir = 4
	},
/turf/open/floor/wood/tile,
/area/misc/hilbertshotel)
"Zs" = (
/obj/structure/table/wood,
/obj/effect/turf_decal/siding/wood{
	dir = 10
	},
/obj/item/instrument/guitar,
/turf/open/floor/wood/tile,
/area/misc/hilbertshotel)

(1,1,1) = {"
BZ
BZ
BZ
BZ
BZ
BZ
BZ
BZ
BZ
BZ
BZ
BZ
BZ
BZ
BZ
BZ
"}
(2,1,1) = {"
BZ
pO
rE
BZ
Ur
TO
BZ
Qt
CC
mp
BZ
Nl
cC
nY
xr
BZ
"}
(3,1,1) = {"
BZ
Iy
MC
Uq
WD
tg
BZ
rA
ag
YC
BZ
HM
Vt
Vt
dl
BZ
"}
(4,1,1) = {"
BZ
Tp
mz
BZ
BZ
BZ
BZ
BZ
hD
BZ
BZ
pR
Vt
Vt
Po
BZ
"}
(5,1,1) = {"
BZ
QR
uD
HN
Fu
hA
HN
Fu
Pm
As
BZ
RW
Vt
Vt
dl
BZ
"}
(6,1,1) = {"
BZ
aP
lp
BZ
xQ
dl
BZ
cI
We
oF
BZ
Qp
Su
Eg
lC
BZ
"}
(7,1,1) = {"
BZ
BZ
BZ
BZ
nk
dl
BZ
BZ
nH
BZ
BZ
BZ
BZ
Hw
BZ
BZ
"}
(8,1,1) = {"
Nj
uz
XA
cN
pM
dl
BZ
WS
yU
PZ
BZ
JY
kS
iB
Zs
BZ
"}
(9,1,1) = {"
eC
yV
yV
Oh
pM
Po
BZ
De
yU
yU
iJ
Wx
tX
YH
Ex
BZ
"}
(10,1,1) = {"
ys
yV
Ng
kf
pM
dl
WR
Ew
yU
Sy
BZ
BZ
BZ
BZ
BZ
BZ
"}
(11,1,1) = {"
gX
Ah
aO
aO
Mt
dl
dz
TX
yU
xv
Og
fN
xv
sx
xv
yr
"}
(12,1,1) = {"
RQ
pM
Px
lh
LH
dl
lT
sS
yU
yU
yU
yU
yU
yU
yU
Dl
"}
(13,1,1) = {"
Yd
pM
vx
JC
lj
Po
BZ
kY
xv
fN
sx
QO
fN
xv
xv
yr
"}
(14,1,1) = {"
gB
pM
GU
xJ
pH
dl
BZ
xv
nb
xv
we
DA
gq
Og
xv
Fs
"}
(15,1,1) = {"
BZ
eS
YF
Dc
br
bH
BZ
xv
Og
sx
Og
pd
xv
xv
yr
Dx
"}
(16,1,1) = {"
BZ
BZ
BZ
BZ
BZ
BZ
BZ
Dx
yr
Dx
Fs
Dx
Dx
yr
Dx
jw
"}
